Date,DHB,Active,Recovered,Deceased,Total
2020-04-16,Auckland,60,123,0,183
2020-04-16,West Coast,2,2,1,5
2020-04-16,Waitemata,105,100,0,205
2020-04-16,Wairarapa,0,8,0,8
2020-04-16,Waikato,106,76,0,182
2020-04-16,Taranaki,3,11,0,14
2020-04-16,Tairawhiti,4,0,0,4
2020-04-16,Southern,74,139,0,213
2020-04-16,South Canterbury,8,6,0,14
2020-04-16,Whanganui,3,4,0,7
2020-04-16,Northland,18,8,0,26
2020-04-16,Mid Central,10,19,0,29
2020-04-16,Lakes,6,9,0,15
2020-04-16,Hutt Valley,7,13,0,20
2020-04-16,Hawke's Bay,26,15,0,41
2020-04-16,Counties Manukau,48,61,0,109
2020-04-16,Capital and Coast,43,46,2,91
2020-04-16,Canterbury,67,70,6,143
2020-04-16,Bay of Plenty,15,29,0,44
2020-04-16,Nelson Marlborough,18,30,0,48
2020-04-16,Total,623,769,9,1401
2020-04-17,Auckland,53,131,0,184
2020-04-17,West Coast,3,2,1,6
2020-04-17,Waitemata,98,107,0,205
2020-04-17,Wairarapa,0,8,0,8
2020-04-17,Waikato,102,80,1,183
2020-04-17,Taranaki,3,11,0,14
2020-04-17,Tairawhiti,3,1,0,4
2020-04-17,Southern,67,147,0,214
2020-04-17,South Canterbury,8,6,0,14
2020-04-17,Whanganui,3,4,0,7
2020-04-17,Northland,17,9,0,26
2020-04-17,Mid Central,10,19,0,29
2020-04-17,Lakes,6,9,0,15
2020-04-17,Hutt Valley,7,13,0,20
2020-04-17,Hawke's Bay,23,18,0,41
2020-04-17,Counties Manukau,42,67,0,109
2020-04-17,Capital and Coast,44,46,2,92
2020-04-17,Canterbury,64,75,7,146
2020-04-17,Bay of Plenty,14,30,0,44
2020-04-17,Nelson Marlborough,15,33,0,48
2020-04-17,Total,582,816,11,1409
2020-04-18,Auckland,49,136,0,185
2020-04-18,West Coast,2,2,1,5
2020-04-18,Waitemata,86,120,0,206
2020-04-18,Wairarapa,0,8,0,8
2020-04-18,Waikato,98,84,1,183
2020-04-18,Taranaki,3,11,0,14
2020-04-18,Tairawhiti,3,1,0,4
2020-04-18,Southern,64,152,0,216
2020-04-18,South Canterbury,9,6,0,15
2020-04-18,Whanganui,4,4,0,8
2020-04-18,Northland,17,10,0,27
2020-04-18,Mid Central,11,20,0,31
2020-04-18,Lakes,5,11,0,16
2020-04-18,Hutt Valley,7,13,0,20
2020-04-18,Hawke's Bay,21,20,0,41
2020-04-18,Counties Manukau,32,78,0,110
2020-04-18,Capital and Coast,42,49,2,93
2020-04-18,Canterbury,64,76,7,147
2020-04-18,Bay of Plenty,13,32,0,45
2020-04-18,Nelson Marlborough,14,34,0,48
2020-04-18,Total,544,867,11,1422
2020-04-19,Auckland,46,139,0,185
2020-04-19,West Coast,1,3,1,5
2020-04-19,Waitemata,84,127,0,211
2020-04-19,Wairarapa,0,8,0,8
2020-04-19,Waikato,90,93,1,184
2020-04-19,Taranaki,3,11,0,14
2020-04-19,Tairawhiti,4,0,0,4
2020-04-19,Southern,62,154,0,216
2020-04-19,South Canterbury,9,6,0,15
2020-04-19,Whanganui,1,7,0,8
2020-04-19,Northland,17,10,0,27
2020-04-19,Mid Central,6,25,0,31
2020-04-19,Lakes,5,11,0,16
2020-04-19,Hutt Valley,7,13,0,20
2020-04-19,Hawke's Bay,19,22,0,41
2020-04-19,Counties Manukau,27,83,0,110
2020-04-19,Capital and Coast,42,49,2,93
2020-04-19,Canterbury,64,79,7,150
2020-04-19,Bay of Plenty,13,32,0,45
2020-04-19,Nelson Marlborough,9,39,0,48
2020-04-19,Total,509,911,11,1431
2020-04-20,Auckland,43,142,0,185
2020-04-20,West Coast,1,3,1,5
2020-04-20,Waitemata,74,138,0,212
2020-04-20,Wairarapa,0,8,0,8
2020-04-20,Waikato,87,97,1,185
2020-04-20,Taranaki,3,11,0,14
2020-04-20,Tairawhiti,3,1,0,4
2020-04-20,Southern,45,170,1,216
2020-04-20,South Canterbury,10,6,0,16
2020-04-20,Whanganui,1,7,0,8
2020-04-20,Northland,17,11,0,28
2020-04-20,Mid Central,4,27,0,31
2020-04-20,Lakes,5,11,0,16
2020-04-20,Hutt Valley,5,15,0,20
2020-04-20,Hawke's Bay,17,24,0,41
2020-04-20,Counties Manukau,25,86,0,111
2020-04-20,Capital and Coast,29,62,2,93
2020-04-20,Canterbury,65,81,7,153
2020-04-20,Bay of Plenty,13,33,0,46
2020-04-20,Nelson Marlborough,7,41,0,48
2020-04-20,Total,454,974,12,1440
2020-04-21,Auckland,41,145,0,186
2020-04-21,West Coast,1,3,1,5
2020-04-21,Waitemata,71,140,1,212
2020-04-21,Wairarapa,0,8,0,8
2020-04-21,Waikato,84,100,1,185
2020-04-21,Taranaki,3,11,0,14
2020-04-21,Tairawhiti,3,1,0,4
2020-04-21,Southern,36,179,1,216
2020-04-21,South Canterbury,10,6,0,16
2020-04-21,Whanganui,2,7,0,9
2020-04-21,Northland,13,14,0,27
2020-04-21,Mid Central,3,28,0,31
2020-04-21,Lakes,4,12,0,16
2020-04-21,Hutt Valley,5,15,0,20
2020-04-21,Hawke's Bay,15,26,0,41
2020-04-21,Counties Manukau,22,89,0,111
2020-04-21,Capital and Coast,29,64,2,95
2020-04-21,Canterbury,63,84,7,154
2020-04-21,Bay of Plenty,14,33,0,47
2020-04-21,Nelson Marlborough,7,41,0,48
2020-04-21,Total,426,1006,13,1445
2020-04-22,Auckland,39,148,0,187
2020-04-22,West Coast,0,4,1,5
2020-04-22,Waitemata,69,142,1,212
2020-04-22,Wairarapa,0,8,0,8
2020-04-22,Waikato,77,107,1,185
2020-04-22,Taranaki,2,12,0,14
2020-04-22,Tairawhiti,3,1,0,4
2020-04-22,Southern,31,184,1,216
2020-04-22,South Canterbury,9,7,0,16
2020-04-22,Whanganui,2,7,0,9
2020-04-22,Northland,13,14,0,27
2020-04-22,Mid Central,2,29,0,31
2020-04-22,Lakes,4,12,0,16
2020-04-22,Hutt Valley,5,15,0,20
2020-04-22,Hawke's Bay,16,26,0,42
2020-04-22,Counties Manukau,22,92,0,114
2020-04-22,Capital and Coast,29,64,2,95
2020-04-22,Canterbury,59,88,8,155
2020-04-22,Bay of Plenty,14,33,0,47
2020-04-22,Nelson Marlborough,5,43,0,48
2020-04-22,Total,401,1036,14,1451
2020-04-24,Auckland,28,155,0,183
2020-04-24,West Coast,0,4,1,5
2020-04-24,Waitemata,56,158,1,215
2020-04-24,Wairarapa,0,8,0,8
2020-04-24,Waikato,73,115,1,189
2020-04-24,Taranaki,2,12,0,14
2020-04-24,Tairawhiti,1,3,0,4
2020-04-24,Southern,22,192,2,216
2020-04-24,South Canterbury,8,8,0,16
2020-04-24,Whanganui,2,7,0,9
2020-04-24,Northland,12,15,0,27
2020-04-24,Mid Central,2,29,0,31
2020-04-24,Lakes,2,14,0,16
2020-04-24,Hutt Valley,5,15,0,20
2020-04-24,Hawke's Bay,16,26,0,42
2020-04-24,Counties Manukau,17,96,0,113
2020-04-24,Capital and Coast,27,66,2,95
2020-04-24,Canterbury,51,97,10,158
2020-04-24,Bay of Plenty,14,33,0,47
2020-04-24,Nelson Marlborough,6,42,0,48
2020-04-24,Total,344,1095,17,1456
2020-04-25,Auckland,26,148,0,174
2020-04-25,West Coast,0,4,1,5
2020-04-25,Waitemata,52,165,2,219
2020-04-25,Wairarapa,0,8,0,8
2020-04-25,Waikato,67,123,1,191
2020-04-25,Taranaki,2,12,0,14
2020-04-25,Tairawhiti,1,3,0,4
2020-04-25,Southern,21,193,2,216
2020-04-25,South Canterbury,8,8,0,16
2020-04-25,Whanganui,2,7,0,9
2020-04-25,Northland,11,17,0,28
2020-04-25,Mid Central,2,29,0,31
2020-04-25,Lakes,2,14,0,16
2020-04-25,Hutt Valley,5,15,0,20
2020-04-25,Hawke's Bay,15,27,0,42
2020-04-25,Counties Manukau,16,102,0,118
2020-04-25,Capital and Coast,27,66,2,95
2020-04-25,Canterbury,48,102,10,160
2020-04-25,Bay of Plenty,14,33,0,47
2020-04-25,Nelson Marlborough,6,42,0,48
2020-04-25,Total,325,1118,18,1461
2020-04-26,Auckland,26,149,0,175
2020-04-26,West Coast,0,4,1,5
2020-04-26,Waitemata,53,165,2,220
2020-04-26,Wairarapa,0,8,0,8
2020-04-26,Waikato,56,135,1,192
2020-04-26,Taranaki,3,12,0,15
2020-04-26,Tairawhiti,1,3,0,4
2020-04-26,Southern,20,194,2,216
2020-04-26,South Canterbury,8,8,0,16
2020-04-26,Whanganui,2,7,0,9
2020-04-26,Northland,11,17,0,28
2020-04-26,Mid Central,2,29,0,31
2020-04-26,Lakes,2,14,0,16
2020-04-26,Hutt Valley,5,15,0,20
2020-04-26,Hawke's Bay,14,29,0,43
2020-04-26,Counties Manukau,18,102,0,120
2020-04-26,Capital and Coast,23,70,2,95
2020-04-26,Canterbury,49,103,10,162
2020-04-26,Bay of Plenty,11,36,0,47
2020-04-26,Nelson Marlborough,6,42,0,48
2020-04-26,Total,310,1142,18,1470
2020-04-27,Auckland,25,150,0,175
2020-04-27,West Coast,0,4,1,5
2020-04-27,Waitemata,46,174,2,222
2020-04-27,Wairarapa,0,8,0,8
2020-04-27,Waikato,48,137,1,186
2020-04-27,Taranaki,4,12,0,16
2020-04-27,Tairawhiti,1,3,0,4
2020-04-27,Southern,16,198,2,216
2020-04-27,South Canterbury,8,8,0,16
2020-04-27,Whanganui,0,9,0,9
2020-04-27,Northland,11,17,0,28
2020-04-27,Mid Central,1,30,0,31
2020-04-27,Lakes,2,14,0,16
2020-04-27,Hutt Valley,4,16,0,20
2020-04-27,Hawke's Bay,13,30,0,43
2020-04-27,Counties Manukau,20,102,0,122
2020-04-27,Capital and Coast,13,80,2,95
2020-04-27,Canterbury,43,109,10,162
2020-04-27,Bay of Plenty,10,37,0,47
2020-04-27,Nelson Marlborough,6,42,0,48
2020-04-27,Total,271,1180,18,1469
2020-04-28,Auckland,22,151,0,173
2020-04-28,West Coast,0,4,1,5
2020-04-28,Waitemata,39,181,3,223
2020-04-28,Wairarapa,0,8,0,8
2020-04-28,Waikato,43,142,1,186
2020-04-28,Taranaki,4,12,0,16
2020-04-28,Tairawhiti,0,4,0,4
2020-04-28,Southern,14,200,2,216
2020-04-28,South Canterbury,8,9,0,17
2020-04-28,Whanganui,0,9,0,9
2020-04-28,Northland,6,22,0,28
2020-04-28,Mid Central,1,30,0,31
2020-04-28,Lakes,2,14,0,16
2020-04-28,Hutt Valley,4,16,0,20
2020-04-28,Hawke's Bay,14,30,0,44
2020-04-28,Counties Manukau,16,108,0,124
2020-04-28,Capital and Coast,9,84,2,95
2020-04-28,Canterbury,43,109,10,162
2020-04-28,Bay of Plenty,10,37,0,47
2020-04-28,Nelson Marlborough,4,44,0,48
2020-04-28,Total,239,1214,19,1472
2020-04-29,Auckland,22,150,0,172
2020-04-29,West Coast,0,4,1,5
2020-04-29,Waitemata,36,184,3,223
2020-04-29,Wairarapa,0,8,0,8
2020-04-29,Waikato,40,146,1,187
2020-04-29,Taranaki,3,13,0,16
2020-04-29,Tairawhiti,0,4,0,4
2020-04-29,Southern,13,201,2,216
2020-04-29,South Canterbury,6,11,0,17
2020-04-29,Whanganui,0,9,0,9
2020-04-29,Northland,6,22,0,28
2020-04-29,Mid Central,1,30,0,31
2020-04-29,Lakes,2,14,0,16
2020-04-29,Hutt Valley,4,16,0,20
2020-04-29,Hawke's Bay,14,30,0,44
2020-04-29,Counties Manukau,16,110,0,126
2020-04-29,Capital and Coast,9,84,2,95
2020-04-29,Canterbury,41,111,10,162
2020-04-29,Bay of Plenty,10,37,0,47
2020-04-29,Nelson Marlborough,3,45,0,48
2020-04-29,Total,226,1229,19,1474
2020-04-30,Auckland,22,151,0,173
2020-04-30,West Coast,0,4,1,5
2020-04-30,Waitemata,35,185,3,223
2020-04-30,Wairarapa,0,8,0,8
2020-04-30,Waikato,37,148,1,186
2020-04-30,Taranaki,2,14,0,16
2020-04-30,Tairawhiti,0,4,0,4
2020-04-30,Southern,12,202,2,216
2020-04-30,South Canterbury,6,11,0,17
2020-04-30,Whanganui,0,9,0,9
2020-04-30,Northland,5,23,0,28
2020-04-30,Mid Central,1,30,0,31
2020-04-30,Lakes,2,14,0,16
2020-04-30,Hutt Valley,4,16,0,20
2020-04-30,Hawke's Bay,14,30,0,44
2020-04-30,Counties Manukau,17,110,0,127
2020-04-30,Capital and Coast,9,84,2,95
2020-04-30,Canterbury,36,116,10,162
2020-04-30,Bay of Plenty,10,37,0,47
2020-04-30,Nelson Marlborough,4,45,0,49
2020-04-30,Total,216,1241,19,1476
2020-05-01,Auckland,23,152,0,175
2020-05-01,West Coast,0,4,1,5
2020-05-01,Waitemata,34,187,3,224
2020-05-01,Wairarapa,0,8,0,8
2020-05-01,Waikato,34,151,1,186
2020-05-01,Taranaki,2,14,0,16
2020-05-01,Tairawhiti,0,4,0,4
2020-05-01,Southern,11,203,2,216
2020-05-01,South Canterbury,5,12,0,17
2020-05-01,Whanganui,0,9,0,9
2020-05-01,Northland,4,24,0,28
2020-05-01,Mid Central,1,30,0,31
2020-05-01,Lakes,2,14,0,16
2020-05-01,Hutt Valley,4,16,0,20
2020-05-01,Hawke's Bay,14,30,0,44
2020-05-01,Counties Manukau,17,110,0,127
2020-05-01,Capital and Coast,7,86,2,95
2020-05-01,Canterbury,36,116,10,162
2020-05-01,Bay of Plenty,10,37,0,47
2020-05-01,Nelson Marlborough,4,45,0,49
2020-05-01,Total,208,1252,19,1479
2020-05-02,Auckland,24,154,0,178
2020-05-02,West Coast,0,4,1,5
2020-05-02,Waitemata,35,188,3,226
2020-05-02,Wairarapa,0,8,0,8
2020-05-02,Waikato,35,150,1,186
2020-05-02,Taranaki,2,14,0,16
2020-05-02,Tairawhiti,0,4,0,4
2020-05-02,Southern,9,205,2,216
2020-05-02,South Canterbury,5,12,0,17
2020-05-02,Whanganui,0,9,0,9
2020-05-02,Northland,4,24,0,28
2020-05-02,Mid Central,0,31,0,31
2020-05-02,Lakes,2,14,0,16
2020-05-02,Hutt Valley,4,16,0,20
2020-05-02,Hawke's Bay,13,31,0,44
2020-05-02,Counties Manukau,17,110,0,127
2020-05-02,Capital and Coast,5,88,2,95
2020-05-02,Canterbury,34,118,11,163
2020-05-02,Bay of Plenty,10,37,0,47
2020-05-02,Nelson Marlborough,3,46,0,49
2020-05-02,Total,202,1263,20,1485
2020-05-03,Auckland,24,154,0,178
2020-05-03,West Coast,0,4,1,5
2020-05-03,Waitemata,36,189,3,228
2020-05-03,Wairarapa,0,8,0,8
2020-05-03,Waikato,34,151,1,186
2020-05-03,Taranaki,2,14,0,16
2020-05-03,Tairawhiti,0,4,0,4
2020-05-03,Southern,9,205,2,216
2020-05-03,South Canterbury,5,12,0,17
2020-05-03,Whanganui,0,9,0,9
2020-05-03,Northland,4,24,0,28
2020-05-03,Mid Central,1,30,0,31
2020-05-03,Lakes,2,14,0,16
2020-05-03,Hutt Valley,4,16,0,20
2020-05-03,Hawke's Bay,13,31,0,44
2020-05-03,Counties Manukau,15,112,0,127
2020-05-03,Capital and Coast,5,88,2,95
2020-05-03,Canterbury,34,118,11,163
2020-05-03,Bay of Plenty,10,37,0,47
2020-05-03,Nelson Marlborough,3,46,0,49
2020-05-03,Total,201,1266,20,1487
2020-05-04,Auckland,26,152,0,178
2020-05-04,West Coast,0,4,1,5
2020-05-04,Waitemata,33,192,3,228
2020-05-04,Wairarapa,0,8,0,8
2020-05-04,Waikato,33,152,1,186
2020-05-04,Taranaki,2,14,0,16
2020-05-04,Tairawhiti,0,4,0,4
2020-05-04,Southern,9,205,2,216
2020-05-04,South Canterbury,5,12,0,17
2020-05-04,Whanganui,0,9,0,9
2020-05-04,Northland,4,24,0,28
2020-05-04,Mid Central,1,30,0,31
2020-05-04,Lakes,2,14,0,16
2020-05-04,Hutt Valley,4,16,0,20
2020-05-04,Hawke's Bay,13,31,0,44
2020-05-04,Counties Manukau,15,112,0,127
2020-05-04,Capital and Coast,5,88,2,95
2020-05-04,Canterbury,29,123,11,163
2020-05-04,Bay of Plenty,7,40,0,47
2020-05-04,Nelson Marlborough,3,46,0,49
2020-05-04,Total,191,1276,20,1487
2020-05-05,Auckland,24,153,0,177
2020-05-05,West Coast,0,4,1,5
2020-05-05,Waitemata,33,192,3,228
2020-05-05,Wairarapa,0,8,0,8
2020-05-05,Waikato,21,164,1,186
2020-05-05,Taranaki,0,16,0,16
2020-05-05,Tairawhiti,0,4,0,4
2020-05-05,Southern,9,205,2,216
2020-05-05,South Canterbury,4,13,0,17
2020-05-05,Whanganui,0,9,0,9
2020-05-05,Northland,4,24,0,28
2020-05-05,Mid Central,1,30,0,31
2020-05-05,Lakes,0,16,0,16
2020-05-05,Hutt Valley,4,16,0,20
2020-05-05,Hawke's Bay,11,33,0,44
2020-05-05,Counties Manukau,15,112,0,127
2020-05-05,Capital and Coast,5,88,2,95
2020-05-05,Canterbury,29,123,11,163
2020-05-05,Bay of Plenty,1,46,0,47
2020-05-05,Nelson Marlborough,3,46,0,49
2020-05-05,Total,164,1302,20,1486
2020-05-06,Auckland,23,155,0,178
2020-05-06,West Coast,0,4,1,5
2020-05-06,Waitemata,30,196,3,229
2020-05-06,Wairarapa,0,8,0,8
2020-05-06,Waikato,19,166,1,186
2020-05-06,Taranaki,0,16,0,16
2020-05-06,Tairawhiti,0,4,0,4
2020-05-06,Southern,9,205,2,216
2020-05-06,South Canterbury,4,13,0,17
2020-05-06,Whanganui,0,9,0,9
2020-05-06,Northland,4,24,0,28
2020-05-06,Mid Central,1,30,0,31
2020-05-06,Lakes,0,16,0,16
2020-05-06,Hutt Valley,4,16,0,20
2020-05-06,Hawke's Bay,11,33,0,44
2020-05-06,Counties Manukau,15,112,0,127
2020-05-06,Capital and Coast,5,88,2,95
2020-05-06,Canterbury,23,128,12,163
2020-05-06,Bay of Plenty,0,47,0,47
2020-05-06,Nelson Marlborough,3,46,0,49
2020-05-06,Total,151,1316,21,1488
2020-05-07,Auckland,21,157,0,178
2020-05-07,West Coast,0,4,1,5
2020-05-07,Waitemata,30,196,3,229
2020-05-07,Wairarapa,0,8,0,8
2020-05-07,Waikato,20,166,1,187
2020-05-07,Taranaki,0,16,0,16
2020-05-07,Tairawhiti,0,4,0,4
2020-05-07,Southern,9,205,2,216
2020-05-07,South Canterbury,3,14,0,17
2020-05-07,Whanganui,0,9,0,9
2020-05-07,Northland,4,24,0,28
2020-05-07,Mid Central,0,31,0,31
2020-05-07,Lakes,0,16,0,16
2020-05-07,Hutt Valley,4,16,0,20
2020-05-07,Hawke's Bay,11,33,0,44
2020-05-07,Counties Manukau,13,114,0,127
2020-05-07,Capital and Coast,1,92,2,95
2020-05-07,Canterbury,17,134,12,163
2020-05-07,Bay of Plenty,0,47,0,47
2020-05-07,Nelson Marlborough,3,46,0,49
2020-05-07,Total,136,1332,21,1489
2020-05-08,Auckland,18,160,0,178
2020-05-08,West Coast,0,4,1,5
2020-05-08,Waitemata,29,198,3,230
2020-05-08,Wairarapa,0,8,0,8
2020-05-08,Waikato,19,167,1,187
2020-05-08,Taranaki,0,16,0,16
2020-05-08,Tairawhiti,0,4,0,4
2020-05-08,Southern,7,207,2,216
2020-05-08,South Canterbury,3,14,0,17
2020-05-08,Whanganui,0,9,0,9
2020-05-08,Northland,4,24,0,28
2020-05-08,Mid Central,0,31,0,31
2020-05-08,Lakes,0,16,0,16
2020-05-08,Hutt Valley,2,18,0,20
2020-05-08,Hawke's Bay,10,34,0,44
2020-05-08,Counties Manukau,11,116,0,127
2020-05-08,Capital and Coast,1,92,2,95
2020-05-08,Canterbury,15,136,12,163
2020-05-08,Bay of Plenty,0,47,0,47
2020-05-08,Nelson Marlborough,3,46,0,49
2020-05-08,Total,122,1347,21,1490
2020-05-09,Auckland,16,162,0,178
2020-05-09,West Coast,0,4,1,5
2020-05-09,Waitemata,26,203,3,232
2020-05-09,Wairarapa,0,8,0,8
2020-05-09,Waikato,16,170,1,187
2020-05-09,Taranaki,0,16,0,16
2020-05-09,Tairawhiti,0,4,0,4
2020-05-09,Southern,8,206,2,216
2020-05-09,South Canterbury,3,14,0,17
2020-05-09,Whanganui,0,9,0,9
2020-05-09,Northland,1,27,0,28
2020-05-09,Mid Central,0,31,0,31
2020-05-09,Lakes,0,16,0,16
2020-05-09,Hutt Valley,0,20,0,20
2020-05-09,Hawke's Bay,9,35,0,44
2020-05-09,Counties Manukau,10,117,0,127
2020-05-09,Capital and Coast,1,92,2,95
2020-05-09,Canterbury,10,141,12,163
2020-05-09,Bay of Plenty,0,47,0,47
2020-05-09,Nelson Marlborough,3,46,0,49
2020-05-09,Total,103,1368,21,1492
2020-05-10,Auckland,16,162,0,178
2020-05-10,West Coast,0,4,1,5
2020-05-10,Waitemata,27,203,3,233
2020-05-10,Wairarapa,0,8,0,8
2020-05-10,Waikato,16,170,1,187
2020-05-10,Taranaki,0,16,0,16
2020-05-10,Tairawhiti,0,4,0,4
2020-05-10,Southern,6,208,2,216
2020-05-10,South Canterbury,3,14,0,17
2020-05-10,Whanganui,0,9,0,9
2020-05-10,Northland,1,27,0,28
2020-05-10,Mid Central,0,31,0,31
2020-05-10,Lakes,0,16,0,16
2020-05-10,Hutt Valley,0,20,0,20
2020-05-10,Hawke's Bay,9,35,0,44
2020-05-10,Counties Manukau,10,118,0,128
2020-05-10,Capital and Coast,1,92,2,95
2020-05-10,Canterbury,10,141,12,163
2020-05-10,Bay of Plenty,0,47,0,47
2020-05-10,Nelson Marlborough,3,46,0,49
2020-05-10,Total,102,1371,21,1494
2020-05-11,Auckland,13,166,0,179
2020-05-11,West Coast,0,4,1,5
2020-05-11,Waitemata,23,208,3,234
2020-05-11,Wairarapa,0,8,0,8
2020-05-11,Waikato,15,172,1,188
2020-05-11,Taranaki,0,16,0,16
2020-05-11,Tairawhiti,0,4,0,4
2020-05-11,Southern,7,207,2,216
2020-05-11,South Canterbury,2,15,0,17
2020-05-11,Whanganui,0,9,0,9
2020-05-11,Northland,1,27,0,28
2020-05-11,Mid Central,1,31,0,32
2020-05-11,Lakes,0,16,0,16
2020-05-11,Hutt Valley,0,20,0,20
2020-05-11,Hawke's Bay,9,35,0,44
2020-05-11,Counties Manukau,6,121,0,127
2020-05-11,Capital and Coast,1,92,2,95
2020-05-11,Canterbury,10,141,12,163
2020-05-11,Bay of Plenty,0,47,0,47
2020-05-11,Nelson Marlborough,2,47,0,49
2020-05-11,Total,90,1386,21,1497
2020-05-12,Auckland,10,169,0,179
2020-05-12,West Coast,0,4,1,5
2020-05-12,Waitemata,19,212,3,234
2020-05-12,Wairarapa,0,8,0,8
2020-05-12,Waikato,13,174,1,188
2020-05-12,Taranaki,0,16,0,16
2020-05-12,Tairawhiti,0,4,0,4
2020-05-12,Southern,7,207,2,216
2020-05-12,South Canterbury,2,15,0,17
2020-05-12,Whanganui,0,9,0,9
2020-05-12,Northland,0,28,0,28
2020-05-12,Mid Central,1,31,0,32
2020-05-12,Lakes,0,16,0,16
2020-05-12,Hutt Valley,0,20,0,20
2020-05-12,Hawke's Bay,9,35,0,44
2020-05-12,Counties Manukau,5,122,0,127
2020-05-12,Capital and Coast,1,92,2,95
2020-05-12,Canterbury,9,142,12,163
2020-05-12,Bay of Plenty,0,47,0,47
2020-05-12,Nelson Marlborough,2,47,0,49
2020-05-12,Total,78,1398,21,1497
2020-05-13,Auckland,10,169,0,179
2020-05-13,West Coast,0,4,1,5
2020-05-13,Waitemata,19,212,3,234
2020-05-13,Wairarapa,0,8,0,8
2020-05-13,Waikato,10,177,1,188
2020-05-13,Taranaki,0,16,0,16
2020-05-13,Tairawhiti,0,4,0,4
2020-05-13,Southern,7,207,2,216
2020-05-13,South Canterbury,2,15,0,17
2020-05-13,Whanganui,0,9,0,9
2020-05-13,Northland,0,28,0,28
2020-05-13,Mid Central,1,31,0,32
2020-05-13,Lakes,0,16,0,16
2020-05-13,Hutt Valley,0,20,0,20
2020-05-13,Hawke's Bay,9,35,0,44
2020-05-13,Counties Manukau,5,122,0,127
2020-05-13,Capital and Coast,0,93,2,95
2020-05-13,Canterbury,9,142,12,163
2020-05-13,Bay of Plenty,0,47,0,47
2020-05-13,Nelson Marlborough,2,47,0,49
2020-05-13,Total,74,1402,21,1497
2020-05-14,Auckland,7,171,0,178
2020-05-14,West Coast,0,4,1,5
2020-05-14,Waitemata,20,212,3,235
2020-05-14,Wairarapa,0,8,0,8
2020-05-14,Waikato,6,181,1,188
2020-05-14,Taranaki,0,16,0,16
2020-05-14,Tairawhiti,0,4,0,4
2020-05-14,Southern,7,207,2,216
2020-05-14,South Canterbury,1,16,0,17
2020-05-14,Whanganui,0,9,0,9
2020-05-14,Northland,0,28,0,28
2020-05-14,Mid Central,1,31,0,32
2020-05-14,Lakes,0,16,0,16
2020-05-14,Hutt Valley,0,20,0,20
2020-05-14,Hawke's Bay,8,36,0,44
2020-05-14,Counties Manukau,4,123,0,127
2020-05-14,Capital and Coast,0,93,2,95
2020-05-14,Canterbury,9,142,12,163
2020-05-14,Bay of Plenty,0,47,0,47
2020-05-14,Nelson Marlborough,2,47,0,49
2020-05-14,Total,65,1411,21,1497
2020-05-15,Auckland,7,171,0,178
2020-05-15,West Coast,0,4,1,5
2020-05-15,Waitemata,20,213,3,236
2020-05-15,Wairarapa,0,8,0,8
2020-05-15,Waikato,6,181,1,188
2020-05-15,Taranaki,0,16,0,16
2020-05-15,Tairawhiti,0,4,0,4
2020-05-15,Southern,4,210,2,216
2020-05-15,South Canterbury,1,16,0,17
2020-05-15,Whanganui,0,9,0,9
2020-05-15,Northland,0,28,0,28
2020-05-15,Mid Central,1,31,0,32
2020-05-15,Lakes,0,16,0,16
2020-05-15,Hutt Valley,0,20,0,20
2020-05-15,Hawke's Bay,6,38,0,44
2020-05-15,Counties Manukau,3,124,0,127
2020-05-15,Capital and Coast,0,93,2,95
2020-05-15,Canterbury,7,144,12,163
2020-05-15,Bay of Plenty,0,47,0,47
2020-05-15,Nelson Marlborough,1,48,0,49
2020-05-15,Total,56,1421,21,1498
2020-05-16,Auckland,7,171,0,178
2020-05-16,West Coast,0,4,1,5
2020-05-16,Waitemata,20,213,3,236
2020-05-16,Wairarapa,0,8,0,8
2020-05-16,Waikato,6,181,1,188
2020-05-16,Taranaki,0,16,0,16
2020-05-16,Tairawhiti,0,4,0,4
2020-05-16,Southern,1,213,2,216
2020-05-16,South Canterbury,0,17,0,17
2020-05-16,Whanganui,0,9,0,9
2020-05-16,Northland,0,28,0,28
2020-05-16,Mid Central,1,31,0,32
2020-05-16,Lakes,0,16,0,16
2020-05-16,Hutt Valley,0,20,0,20
2020-05-16,Hawke's Bay,5,39,0,44
2020-05-16,Counties Manukau,3,124,0,127
2020-05-16,Capital and Coast,0,93,2,95
2020-05-16,Canterbury,5,146,12,163
2020-05-16,Bay of Plenty,0,47,0,47
2020-05-16,Nelson Marlborough,1,48,0,49
2020-05-16,Total,49,1428,21,1498
2020-05-17,Auckland,4,174,0,178
2020-05-17,West Coast,0,4,1,5
2020-05-17,Waitemata,18,215,3,236
2020-05-17,Wairarapa,0,8,0,8
2020-05-17,Waikato,6,181,1,188
2020-05-17,Taranaki,0,16,0,16
2020-05-17,Tairawhiti,0,4,0,4
2020-05-17,Southern,1,213,2,216
2020-05-17,South Canterbury,0,17,0,17
2020-05-17,Whanganui,0,9,0,9
2020-05-17,Northland,0,28,0,28
2020-05-17,Mid Central,1,31,0,32
2020-05-17,Lakes,0,16,0,16
2020-05-17,Hutt Valley,0,20,0,20
2020-05-17,Hawke's Bay,5,39,0,44
2020-05-17,Counties Manukau,3,124,0,127
2020-05-17,Capital and Coast,0,93,2,95
2020-05-17,Canterbury,6,146,12,164
2020-05-17,Bay of Plenty,0,47,0,47
2020-05-17,Nelson Marlborough,1,48,0,49
2020-05-17,Total,45,1433,21,1499
2020-05-18,Auckland,4,174,0,178
2020-05-18,West Coast,0,4,1,5
2020-05-18,Waitemata,18,215,3,236
2020-05-18,Wairarapa,0,8,0,8
2020-05-18,Waikato,6,181,1,188
2020-05-18,Taranaki,0,16,0,16
2020-05-18,Tairawhiti,0,4,0,4
2020-05-18,Southern,1,213,2,216
2020-05-18,South Canterbury,0,17,0,17
2020-05-18,Whanganui,0,9,0,9
2020-05-18,Northland,0,28,0,28
2020-05-18,Mid Central,1,31,0,32
2020-05-18,Lakes,0,16,0,16
2020-05-18,Hutt Valley,0,20,0,20
2020-05-18,Hawke's Bay,5,39,0,44
2020-05-18,Counties Manukau,3,124,0,127
2020-05-18,Capital and Coast,0,93,2,95
2020-05-18,Canterbury,6,146,12,164
2020-05-18,Bay of Plenty,0,47,0,47
2020-05-18,Nelson Marlborough,1,48,0,49
2020-05-18,Total,45,1433,21,1499
2020-05-19,Auckland,4,174,0,178
2020-05-19,West Coast,0,4,1,5
2020-05-19,Waitemata,17,216,3,236
2020-05-19,Wairarapa,0,8,0,8
2020-05-19,Waikato,4,183,1,188
2020-05-19,Taranaki,0,16,0,16
2020-05-19,Tairawhiti,0,4,0,4
2020-05-19,Southern,1,213,2,216
2020-05-19,South Canterbury,0,17,0,17
2020-05-19,Whanganui,0,9,0,9
2020-05-19,Northland,0,28,0,28
2020-05-19,Mid Central,0,32,0,32
2020-05-19,Lakes,0,16,0,16
2020-05-19,Hutt Valley,0,20,0,20
2020-05-19,Hawke's Bay,5,39,0,44
2020-05-19,Counties Manukau,3,128,0,131
2020-05-19,Capital and Coast,0,93,2,95
2020-05-19,Canterbury,5,147,12,164
2020-05-19,Bay of Plenty,0,47,0,47
2020-05-19,Nelson Marlborough,1,48,0,49
2020-05-19,Total,40,1442,21,1503
2020-05-20,Auckland,4,173,0,177
2020-05-20,West Coast,0,4,1,5
2020-05-20,Waitemata,15,218,3,236
2020-05-20,Wairarapa,0,8,0,8
2020-05-20,Waikato,1,186,1,188
2020-05-20,Taranaki,0,16,0,16
2020-05-20,Tairawhiti,0,4,0,4
2020-05-20,Southern,1,213,2,216
2020-05-20,South Canterbury,0,17,0,17
2020-05-20,Whanganui,0,9,0,9
2020-05-20,Northland,0,28,0,28
2020-05-20,Mid Central,0,32,0,32
2020-05-20,Lakes,0,16,0,16
2020-05-20,Hutt Valley,0,20,0,20
2020-05-20,Hawke's Bay,5,39,0,44
2020-05-20,Counties Manukau,3,129,0,132
2020-05-20,Capital and Coast,0,93,2,95
2020-05-20,Canterbury,5,147,12,164
2020-05-20,Bay of Plenty,0,47,0,47
2020-05-20,Nelson Marlborough,1,48,0,49
2020-05-20,Total,35,1447,21,1503
2020-05-21,Auckland,3,174,0,177
2020-05-21,West Coast,0,4,1,5
2020-05-21,Waitemata,14,219,3,236
2020-05-21,Wairarapa,0,8,0,8
2020-05-21,Waikato,1,186,1,188
2020-05-21,Taranaki,0,16,0,16
2020-05-21,Tairawhiti,0,4,0,4
2020-05-21,Southern,0,214,2,216
2020-05-21,South Canterbury,0,17,0,17
2020-05-21,Whanganui,0,9,0,9
2020-05-21,Northland,0,28,0,28
2020-05-21,Mid Central,0,32,0,32
2020-05-21,Lakes,0,16,0,16
2020-05-21,Hutt Valley,0,20,0,20
2020-05-21,Hawke's Bay,5,39,0,44
2020-05-21,Counties Manukau,3,129,0,132
2020-05-21,Capital and Coast,0,93,2,95
2020-05-21,Canterbury,3,149,12,164
2020-05-21,Bay of Plenty,0,47,0,47
2020-05-21,Nelson Marlborough,1,48,0,49
2020-05-21,Total,30,1452,21,1503
2020-05-22,Auckland,3,175,0,178
2020-05-22,West Coast,0,4,1,5
2020-05-22,Waitemata,14,219,3,236
2020-05-22,Wairarapa,0,8,0,8
2020-05-22,Waikato,1,186,1,188
2020-05-22,Taranaki,0,16,0,16
2020-05-22,Tairawhiti,0,4,0,4
2020-05-22,Southern,0,214,2,216
2020-05-22,South Canterbury,0,17,0,17
2020-05-22,Whanganui,0,9,0,9
2020-05-22,Northland,0,28,0,28
2020-05-22,Mid Central,0,32,0,32
2020-05-22,Lakes,0,16,0,16
2020-05-22,Hutt Valley,0,20,0,20
2020-05-22,Hawke's Bay,5,39,0,44
2020-05-22,Counties Manukau,2,130,0,132
2020-05-22,Capital and Coast,0,93,2,95
2020-05-22,Canterbury,2,150,12,164
2020-05-22,Bay of Plenty,0,47,0,47
2020-05-22,Nelson Marlborough,1,48,0,49
2020-05-22,Total,28,1455,21,1504
2020-05-23,Auckland,3,175,0,178
2020-05-23,West Coast,0,4,1,5
2020-05-23,Waitemata,14,219,3,236
2020-05-23,Wairarapa,0,8,0,8
2020-05-23,Waikato,1,186,1,188
2020-05-23,Taranaki,0,16,0,16
2020-05-23,Tairawhiti,0,4,0,4
2020-05-23,Southern,0,214,2,216
2020-05-23,South Canterbury,0,17,0,17
2020-05-23,Whanganui,0,9,0,9
2020-05-23,Northland,0,28,0,28
2020-05-23,Mid Central,0,32,0,32
2020-05-23,Lakes,0,16,0,16
2020-05-23,Hutt Valley,0,20,0,20
2020-05-23,Hawke's Bay,5,39,0,44
2020-05-23,Counties Manukau,2,130,0,132
2020-05-23,Capital and Coast,0,93,2,95
2020-05-23,Canterbury,2,150,12,164
2020-05-23,Bay of Plenty,0,47,0,47
2020-05-23,Nelson Marlborough,1,48,0,49
2020-05-23,Total,28,1455,21,1504
2020-05-24,Auckland,3,175,0,178
2020-05-24,West Coast,0,4,1,5
2020-05-24,Waitemata,14,219,3,236
2020-05-24,Wairarapa,0,8,0,8
2020-05-24,Waikato,1,186,1,188
2020-05-24,Taranaki,0,16,0,16
2020-05-24,Tairawhiti,0,4,0,4
2020-05-24,Southern,0,214,2,216
2020-05-24,South Canterbury,0,17,0,17
2020-05-24,Whanganui,0,9,0,9
2020-05-24,Northland,0,28,0,28
2020-05-24,Mid Central,0,32,0,32
2020-05-24,Lakes,0,16,0,16
2020-05-24,Hutt Valley,0,20,0,20
2020-05-24,Hawke's Bay,5,39,0,44
2020-05-24,Counties Manukau,1,131,0,132
2020-05-24,Capital and Coast,0,93,2,95
2020-05-24,Canterbury,2,150,12,164
2020-05-24,Bay of Plenty,0,47,0,47
2020-05-24,Nelson Marlborough,1,48,0,49
2020-05-24,Total,27,1456,21,1504
2020-05-26,Auckland,3,175,0,178
2020-05-26,West Coast,0,4,1,5
2020-05-26,Waitemata,14,219,3,236
2020-05-26,Wairarapa,0,8,0,8
2020-05-26,Waikato,1,186,1,188
2020-05-26,Taranaki,0,16,0,16
2020-05-26,Tairawhiti,0,4,0,4
2020-05-26,Southern,0,214,2,216
2020-05-26,South Canterbury,0,17,0,17
2020-05-26,Whanganui,0,9,0,9
2020-05-26,Northland,0,28,0,28
2020-05-26,Mid Central,0,32,0,32
2020-05-26,Lakes,0,16,0,16
2020-05-26,Hutt Valley,0,20,0,20
2020-05-26,Hawke's Bay,0,44,0,44
2020-05-26,Counties Manukau,1,131,0,132
2020-05-26,Capital and Coast,0,93,2,95
2020-05-26,Canterbury,2,150,12,164
2020-05-26,Bay of Plenty,0,47,0,47
2020-05-26,Nelson Marlborough,1,48,0,49
2020-05-26,Total,22,1461,21,1504
2020-05-27,Auckland,3,175,0,178
2020-05-27,West Coast,0,4,1,5
2020-05-27,Waitemata,14,219,3,236
2020-05-27,Wairarapa,0,8,0,8
2020-05-27,Waikato,1,186,1,188
2020-05-27,Taranaki,0,16,0,16
2020-05-27,Tairawhiti,0,4,0,4
2020-05-27,Southern,0,214,2,216
2020-05-27,South Canterbury,0,17,0,17
2020-05-27,Whanganui,0,9,0,9
2020-05-27,Northland,0,28,0,28
2020-05-27,Mid Central,0,32,0,32
2020-05-27,Lakes,0,16,0,16
2020-05-27,Hutt Valley,0,20,0,20
2020-05-27,Hawke's Bay,0,44,0,44
2020-05-27,Counties Manukau,1,131,0,132
2020-05-27,Capital and Coast,0,93,2,95
2020-05-27,Canterbury,2,150,12,164
2020-05-27,Bay of Plenty,0,47,0,47
2020-05-27,Nelson Marlborough,0,49,0,49
2020-05-27,Total,21,1462,21,1504
2020-05-28,Auckland,2,176,0,178
2020-05-28,West Coast,0,4,1,5
2020-05-28,Waitemata,5,227,4,236
2020-05-28,Wairarapa,0,8,0,8
2020-05-28,Waikato,0,187,1,188
2020-05-28,Taranaki,0,16,0,16
2020-05-28,Tairawhiti,0,4,0,4
2020-05-28,Southern,0,214,2,216
2020-05-28,South Canterbury,0,17,0,17
2020-05-28,Whanganui,0,9,0,9
2020-05-28,Northland,0,28,0,28
2020-05-28,Mid Central,0,32,0,32
2020-05-28,Lakes,0,16,0,16
2020-05-28,Hutt Valley,0,20,0,20
2020-05-28,Hawke's Bay,0,44,0,44
2020-05-28,Counties Manukau,1,131,0,132
2020-05-28,Capital and Coast,0,93,2,95
2020-05-28,Canterbury,0,152,12,164
2020-05-28,Bay of Plenty,0,47,0,47
2020-05-28,Nelson Marlborough,0,49,0,49
2020-05-28,Total,8,1474,22,1504
2020-05-29,Auckland,1,177,0,178
2020-05-29,West Coast,0,4,1,5
2020-05-29,Waitemata,0,232,4,236
2020-05-29,Wairarapa,0,8,0,8
2020-05-29,Waikato,0,187,1,188
2020-05-29,Taranaki,0,16,0,16
2020-05-29,Tairawhiti,0,4,0,4
2020-05-29,Southern,0,214,2,216
2020-05-29,South Canterbury,0,17,0,17
2020-05-29,Whanganui,0,9,0,9
2020-05-29,Northland,0,28,0,28
2020-05-29,Mid Central,0,32,0,32
2020-05-29,Lakes,0,16,0,16
2020-05-29,Hutt Valley,0,20,0,20
2020-05-29,Hawke's Bay,0,44,0,44
2020-05-29,Counties Manukau,0,132,0,132
2020-05-29,Capital and Coast,0,93,2,95
2020-05-29,Canterbury,0,152,12,164
2020-05-29,Bay of Plenty,0,47,0,47
2020-05-29,Nelson Marlborough,0,49,0,49
2020-05-29,Total,1,1481,22,1504
2020-05-30,Auckland,1,177,0,178
2020-05-30,West Coast,0,4,1,5
2020-05-30,Waitemata,0,233,4,237
2020-05-30,Wairarapa,0,8,0,8
2020-05-30,Waikato,0,187,1,188
2020-05-30,Taranaki,0,16,0,16
2020-05-30,Tairawhiti,0,4,0,4
2020-05-30,Southern,0,214,2,216
2020-05-30,South Canterbury,0,17,0,17
2020-05-30,Whanganui,0,9,0,9
2020-05-30,Northland,0,28,0,28
2020-05-30,Mid Central,0,32,0,32
2020-05-30,Lakes,0,16,0,16
2020-05-30,Hutt Valley,0,20,0,20
2020-05-30,Hawke's Bay,0,44,0,44
2020-05-30,Counties Manukau,0,131,0,131
2020-05-30,Capital and Coast,0,93,2,95
2020-05-30,Canterbury,0,152,12,164
2020-05-30,Bay of Plenty,0,47,0,47
2020-05-30,Nelson Marlborough,0,49,0,49
2020-05-30,Total,1,1481,22,1504
2020-06-08,Auckland,0,178,0,178
2020-06-08,West Coast,0,4,1,5
2020-06-08,Waitemata,0,233,4,237
2020-06-08,Wairarapa,0,8,0,8
2020-06-08,Waikato,0,187,1,188
2020-06-08,Taranaki,0,16,0,16
2020-06-08,Tairawhiti,0,4,0,4
2020-06-08,Southern,0,214,2,216
2020-06-08,South Canterbury,0,17,0,17
2020-06-08,Whanganui,0,9,0,9
2020-06-08,Northland,0,28,0,28
2020-06-08,Mid Central,0,32,0,32
2020-06-08,Lakes,0,16,0,16
2020-06-08,Hutt Valley,0,20,0,20
2020-06-08,Hawke's Bay,0,44,0,44
2020-06-08,Counties Manukau,0,131,0,131
2020-06-08,Capital and Coast,0,93,2,95
2020-06-08,Canterbury,0,152,12,164
2020-06-08,Bay of Plenty,0,47,0,47
2020-06-08,Nelson Marlborough,0,49,0,49
2020-06-08,Total,0,1482,22,1504
2020-06-16,Auckland,0,178,0,178
2020-06-16,West Coast,0,4,1,5
2020-06-16,Waitemata,0,233,4,237
2020-06-16,Wairarapa,0,8,0,8
2020-06-16,Waikato,0,187,1,188
2020-06-16,Taranaki,0,16,0,16
2020-06-16,Tairawhiti,0,4,0,4
2020-06-16,Southern,0,214,2,216
2020-06-16,South Canterbury,0,17,0,17
2020-06-16,Whanganui,0,9,0,9
2020-06-16,Northland,0,28,0,28
2020-06-16,Mid Central,0,32,0,32
2020-06-16,Lakes,0,16,0,16
2020-06-16,Hutt Valley,2,20,0,22
2020-06-16,Hawke's Bay,0,44,0,44
2020-06-16,Counties Manukau,0,131,0,131
2020-06-16,Capital and Coast,0,93,2,95
2020-06-16,Canterbury,0,152,12,164
2020-06-16,Bay of Plenty,0,47,0,47
2020-06-16,Nelson Marlborough,0,49,0,49
2020-06-16,Total,2,1482,22,1506
2020-06-17,Auckland,0,178,0,178
2020-06-17,West Coast,0,4,1,5
2020-06-17,Waitemata,0,233,4,237
2020-06-17,Wairarapa,0,8,0,8
2020-06-17,Waikato,0,187,1,188
2020-06-17,Taranaki,0,16,0,16
2020-06-17,Tairawhiti,0,4,0,4
2020-06-17,Southern,0,214,2,216
2020-06-17,South Canterbury,0,17,0,17
2020-06-17,Whanganui,0,9,0,9
2020-06-17,Northland,0,28,0,28
2020-06-17,Mid Central,0,32,0,32
2020-06-17,Lakes,0,16,0,16
2020-06-17,Hutt Valley,2,20,0,22
2020-06-17,Hawke's Bay,0,44,0,44
2020-06-17,Counties Manukau,0,131,0,131
2020-06-17,Capital and Coast,0,93,2,95
2020-06-17,Canterbury,0,152,12,164
2020-06-17,Bay of Plenty,0,47,0,47
2020-06-17,Nelson Marlborough,0,49,0,49
2020-06-17,Total,2,1482,22,1506
2020-06-18,Auckland,0,178,0,178
2020-06-18,West Coast,0,4,1,5
2020-06-18,Waitemata,0,233,4,237
2020-06-18,Wairarapa,0,8,0,8
2020-06-18,Waikato,0,187,1,188
2020-06-18,Taranaki,0,16,0,16
2020-06-18,Tairawhiti,0,4,0,4
2020-06-18,Southern,0,214,2,216
2020-06-18,South Canterbury,0,17,0,17
2020-06-18,Whanganui,0,9,0,9
2020-06-18,Northland,0,28,0,28
2020-06-18,Mid Central,0,32,0,32
2020-06-18,Lakes,0,16,0,16
2020-06-18,Hutt Valley,2,20,0,22
2020-06-18,Hawke's Bay,0,44,0,44
2020-06-18,Counties Manukau,1,131,0,132
2020-06-18,Capital and Coast,0,93,2,95
2020-06-18,Canterbury,0,152,12,164
2020-06-18,Bay of Plenty,0,47,0,47
2020-06-18,Nelson Marlborough,0,49,0,49
2020-06-18,Total,3,1482,22,1507
2020-06-19,Auckland,0,178,0,178
2020-06-19,West Coast,0,4,1,5
2020-06-19,Waitemata,0,233,4,237
2020-06-19,Wairarapa,0,8,0,8
2020-06-19,Waikato,0,187,1,188
2020-06-19,Taranaki,0,16,0,16
2020-06-19,Tairawhiti,0,4,0,4
2020-06-19,Southern,0,214,2,216
2020-06-19,South Canterbury,0,17,0,17
2020-06-19,Whanganui,0,9,0,9
2020-06-19,Northland,0,28,0,28
2020-06-19,Mid Central,0,32,0,32
2020-06-19,Lakes,0,16,0,16
2020-06-19,Hutt Valley,2,20,0,22
2020-06-19,Hawke's Bay,0,44,0,44
2020-06-19,Counties Manukau,1,131,0,132
2020-06-19,Capital and Coast,0,93,2,95
2020-06-19,Canterbury,0,152,12,164
2020-06-19,Bay of Plenty,0,47,0,47
2020-06-19,Nelson Marlborough,0,49,0,49
2020-06-19,Total,3,1482,22,1507
2020-06-20,Auckland,0,178,0,178
2020-06-20,West Coast,0,4,1,5
2020-06-20,Waitemata,0,233,4,237
2020-06-20,Wairarapa,0,8,0,8
2020-06-20,Waikato,0,187,1,188
2020-06-20,Taranaki,0,16,0,16
2020-06-20,Tairawhiti,0,4,0,4
2020-06-20,Southern,0,214,2,216
2020-06-20,South Canterbury,0,17,0,17
2020-06-20,Whanganui,0,9,0,9
2020-06-20,Northland,0,28,0,28
2020-06-20,Mid Central,0,32,0,32
2020-06-20,Lakes,0,16,0,16
2020-06-20,Hutt Valley,2,20,0,22
2020-06-20,Hawke's Bay,0,44,0,44
2020-06-20,Counties Manukau,3,131,0,134
2020-06-20,Capital and Coast,0,93,2,95
2020-06-20,Canterbury,0,152,12,164
2020-06-20,Bay of Plenty,0,47,0,47
2020-06-20,Nelson Marlborough,0,49,0,49
2020-06-20,Total,5,1482,22,1509
2020-06-21,Auckland,0,178,0,178
2020-06-21,West Coast,0,4,1,5
2020-06-21,Waitemata,0,233,4,237
2020-06-21,Wairarapa,0,8,0,8
2020-06-21,Waikato,0,187,1,188
2020-06-21,Taranaki,0,16,0,16
2020-06-21,Tairawhiti,0,4,0,4
2020-06-21,Southern,0,214,2,216
2020-06-21,South Canterbury,0,17,0,17
2020-06-21,Whanganui,0,9,0,9
2020-06-21,Northland,0,28,0,28
2020-06-21,Mid Central,0,32,0,32
2020-06-21,Lakes,0,16,0,16
2020-06-21,Hutt Valley,2,20,0,22
2020-06-21,Hawke's Bay,0,44,0,44
2020-06-21,Counties Manukau,5,131,0,136
2020-06-21,Capital and Coast,0,93,2,95
2020-06-21,Canterbury,0,152,12,164
2020-06-21,Bay of Plenty,0,47,0,47
2020-06-21,Nelson Marlborough,0,49,0,49
2020-06-21,Total,7,1482,22,1511
2020-06-22,Auckland,2,178,0,180
2020-06-22,West Coast,0,4,1,5
2020-06-22,Waitemata,0,233,4,237
2020-06-22,Wairarapa,0,8,0,8
2020-06-22,Waikato,0,187,1,188
2020-06-22,Taranaki,0,16,0,16
2020-06-22,Tairawhiti,0,4,0,4
2020-06-22,Southern,0,214,2,216
2020-06-22,South Canterbury,0,17,0,17
2020-06-22,Whanganui,0,9,0,9
2020-06-22,Northland,0,28,0,28
2020-06-22,Mid Central,0,32,0,32
2020-06-22,Lakes,0,16,0,16
2020-06-22,Hutt Valley,2,20,0,22
2020-06-22,Hawke's Bay,0,44,0,44
2020-06-22,Counties Manukau,5,131,0,136
2020-06-22,Capital and Coast,0,93,2,95
2020-06-22,Canterbury,0,152,12,164
2020-06-22,Bay of Plenty,0,47,0,47
2020-06-22,Nelson Marlborough,0,49,0,49
2020-06-22,Total,9,1482,22,1513
2020-06-23,Auckland,2,178,0,180
2020-06-23,West Coast,0,4,1,5
2020-06-23,Waitemata,0,233,4,237
2020-06-23,Wairarapa,0,8,0,8
2020-06-23,Waikato,0,187,1,188
2020-06-23,Taranaki,0,16,0,16
2020-06-23,Tairawhiti,0,4,0,4
2020-06-23,Southern,0,214,2,216
2020-06-23,South Canterbury,0,17,0,17
2020-06-23,Whanganui,0,9,0,9
2020-06-23,Northland,0,28,0,28
2020-06-23,Mid Central,0,32,0,32
2020-06-23,Lakes,0,16,0,16
2020-06-23,Hutt Valley,1,21,0,22
2020-06-23,Hawke's Bay,0,44,0,44
2020-06-23,Counties Manukau,7,131,0,138
2020-06-23,Capital and Coast,0,93,2,95
2020-06-23,Canterbury,0,152,12,164
2020-06-23,Bay of Plenty,0,47,0,47
2020-06-23,Nelson Marlborough,0,49,0,49
2020-06-23,Total,10,1483,22,1515
2020-06-24,Auckland,1,178,0,179
2020-06-24,West Coast,0,4,1,5
2020-06-24,Waitemata,0,233,4,237
2020-06-24,Wairarapa,0,8,0,8
2020-06-24,Waikato,0,187,1,188
2020-06-24,Taranaki,0,16,0,16
2020-06-24,Tairawhiti,0,4,0,4
2020-06-24,Southern,0,214,2,216
2020-06-24,South Canterbury,0,17,0,17
2020-06-24,Whanganui,0,9,0,9
2020-06-24,Northland,0,28,0,28
2020-06-24,Mid Central,0,32,0,32
2020-06-24,Lakes,0,16,0,16
2020-06-24,Hutt Valley,1,21,0,22
2020-06-24,Hawke's Bay,0,44,0,44
2020-06-24,Counties Manukau,9,131,0,140
2020-06-24,Capital and Coast,0,93,2,95
2020-06-24,Canterbury,0,152,12,164
2020-06-24,Bay of Plenty,0,47,0,47
2020-06-24,Nelson Marlborough,0,49,0,49
2020-06-24,Total,11,1483,22,1516
2020-06-25,Auckland,0,178,0,178
2020-06-25,Whanganui,0,9,0,9
2020-06-25,West Coast,0,4,1,5
2020-06-25,Waitemata,0,233,4,237
2020-06-25,Wairarapa,0,8,0,8
2020-06-25,Waikato,0,187,1,188
2020-06-25,Taranaki,0,16,0,16
2020-06-25,Tairawhiti,0,4,0,4
2020-06-25,Southern,0,214,2,216
2020-06-25,South Canterbury,0,17,0,17
2020-06-25,Northland,0,28,0,28
2020-06-25,Nelson Marlborough,0,49,0,49
2020-06-25,Mid Central,0,32,0,32
2020-06-25,Lakes,0,16,0,16
2020-06-25,Hutt Valley,0,22,0,22
2020-06-25,Hawke's Bay,0,44,0,44
2020-06-25,Counties Manukau,0,131,0,131
2020-06-25,Capital and Coast,0,93,2,95
2020-06-25,Canterbury,0,152,12,164
2020-06-25,Bay of Plenty,0,47,0,47
2020-06-25,Managed Isolation,13,0,0,13
2020-06-25,Total,13,1484,22,1519
2020-06-26,Auckland,0,178,0,178
2020-06-26,Whanganui,0,9,0,9
2020-06-26,West Coast,0,4,1,5
2020-06-26,Waitemata,0,233,4,237
2020-06-26,Wairarapa,0,8,0,8
2020-06-26,Waikato,0,187,1,188
2020-06-26,Taranaki,0,16,0,16
2020-06-26,Tairawhiti,0,4,0,4
2020-06-26,Southern,0,214,2,216
2020-06-26,South Canterbury,0,17,0,17
2020-06-26,Northland,0,28,0,28
2020-06-26,Nelson Marlborough,0,49,0,49
2020-06-26,Mid Central,0,32,0,32
2020-06-26,Lakes,0,16,0,16
2020-06-26,Hutt Valley,0,22,0,22
2020-06-26,Hawke's Bay,0,44,0,44
2020-06-26,Counties Manukau,0,131,0,131
2020-06-26,Capital and Coast,0,93,2,95
2020-06-26,Canterbury,0,152,12,164
2020-06-26,Bay of Plenty,0,47,0,47
2020-06-26,Managed Isolation,14,0,0,14
2020-06-26,Total,14,1484,22,1520
2020-06-27,Auckland,0,178,0,178
2020-06-27,Whanganui,0,9,0,9
2020-06-27,West Coast,0,4,1,5
2020-06-27,Waitemata,0,233,4,237
2020-06-27,Wairarapa,0,8,0,8
2020-06-27,Waikato,0,187,1,188
2020-06-27,Taranaki,0,16,0,16
2020-06-27,Tairawhiti,0,4,0,4
2020-06-27,Southern,0,214,2,216
2020-06-27,South Canterbury,0,17,0,17
2020-06-27,Northland,0,28,0,28
2020-06-27,Nelson Marlborough,0,49,0,49
2020-06-27,Mid Central,0,32,0,32
2020-06-27,Lakes,0,16,0,16
2020-06-27,Hutt Valley,0,22,0,22
2020-06-27,Hawke's Bay,0,44,0,44
2020-06-27,Counties Manukau,0,131,0,131
2020-06-27,Capital and Coast,0,93,2,95
2020-06-27,Canterbury,0,152,12,164
2020-06-27,Bay of Plenty,0,47,0,47
2020-06-27,Managed Isolation,16,0,0,16
2020-06-27,Total,16,1484,22,1522
2020-06-28,Auckland,0,178,0,178
2020-06-28,Whanganui,0,9,0,9
2020-06-28,West Coast,0,4,1,5
2020-06-28,Waitemata,0,233,4,237
2020-06-28,Wairarapa,0,8,0,8
2020-06-28,Waikato,0,187,1,188
2020-06-28,Taranaki,0,16,0,16
2020-06-28,Tairawhiti,0,4,0,4
2020-06-28,Southern,0,214,2,216
2020-06-28,South Canterbury,0,17,0,17
2020-06-28,Northland,0,28,0,28
2020-06-28,Nelson Marlborough,0,49,0,49
2020-06-28,Mid Central,0,32,0,32
2020-06-28,Lakes,0,16,0,16
2020-06-28,Hutt Valley,0,22,0,22
2020-06-28,Hawke's Bay,0,44,0,44
2020-06-28,Counties Manukau,0,131,0,131
2020-06-28,Capital and Coast,0,93,2,95
2020-06-28,Canterbury,0,152,12,164
2020-06-28,Bay of Plenty,0,47,0,47
2020-06-28,Managed Isolation & Quarantine,20,0,0,20
2020-06-28,Total,20,1484,22,1526
2020-06-29,Auckland,0,178,0,178
2020-06-29,Whanganui,0,9,0,9
2020-06-29,West Coast,0,4,1,5
2020-06-29,Waitemata,0,233,4,237
2020-06-29,Wairarapa,0,8,0,8
2020-06-29,Waikato,0,187,1,188
2020-06-29,Taranaki,0,16,0,16
2020-06-29,Tairawhiti,0,4,0,4
2020-06-29,Southern,0,214,2,216
2020-06-29,South Canterbury,0,17,0,17
2020-06-29,Northland,0,28,0,28
2020-06-29,Nelson Marlborough,0,49,0,49
2020-06-29,Mid Central,0,32,0,32
2020-06-29,Lakes,0,16,0,16
2020-06-29,Hutt Valley,0,22,0,22
2020-06-29,Hawke's Bay,0,44,0,44
2020-06-29,Counties Manukau,0,131,0,131
2020-06-29,Capital and Coast,0,93,2,95
2020-06-29,Canterbury,0,152,12,164
2020-06-29,Bay of Plenty,0,47,0,47
2020-06-29,Managed Isolation & Quarantine,22,0,0,22
2020-06-29,Total,22,1484,22,1528
2020-06-30,Auckland,0,178,0,178
2020-06-30,Whanganui,0,9,0,9
2020-06-30,West Coast,0,4,1,5
2020-06-30,Waitemata,0,233,4,237
2020-06-30,Wairarapa,0,8,0,8
2020-06-30,Waikato,0,187,1,188
2020-06-30,Taranaki,0,16,0,16
2020-06-30,Tairawhiti,0,4,0,4
2020-06-30,Southern,0,214,2,216
2020-06-30,South Canterbury,0,17,0,17
2020-06-30,Northland,0,28,0,28
2020-06-30,Nelson Marlborough,0,49,0,49
2020-06-30,Mid Central,0,32,0,32
2020-06-30,Lakes,0,16,0,16
2020-06-30,Hutt Valley,0,22,0,22
2020-06-30,Hawke's Bay,0,44,0,44
2020-06-30,Counties Manukau,0,131,0,131
2020-06-30,Capital and Coast,0,93,2,95
2020-06-30,Canterbury,0,152,12,164
2020-06-30,Bay of Plenty,0,47,0,47
2020-06-30,Managed Isolation & Quarantine,22,0,0,22
2020-06-30,Total,22,1484,22,1528
2020-07-02,Auckland,0,178,0,178
2020-07-02,Whanganui,0,9,0,9
2020-07-02,West Coast,0,4,1,5
2020-07-02,Waitemata,0,233,4,237
2020-07-02,Wairarapa,0,8,0,8
2020-07-02,Waikato,0,187,1,188
2020-07-02,Taranaki,0,16,0,16
2020-07-02,Tairawhiti,0,4,0,4
2020-07-02,Southern,0,214,2,216
2020-07-02,South Canterbury,0,17,0,17
2020-07-02,Northland,0,28,0,28
2020-07-02,Nelson Marlborough,0,49,0,49
2020-07-02,Mid Central,0,32,0,32
2020-07-02,Lakes,0,16,0,16
2020-07-02,Hutt Valley,0,22,0,22
2020-07-02,Hawke's Bay,0,44,0,44
2020-07-02,Counties Manukau,0,131,0,131
2020-07-02,Capital and Coast,0,93,2,95
2020-07-02,Canterbury,0,152,12,164
2020-07-02,Bay of Plenty,0,47,0,47
2020-07-02,Managed Isolation & Quarantine,18,6,0,24
2020-07-02,Total,18,1490,22,1530
2020-07-03,Auckland,0,178,0,178
2020-07-03,Whanganui,0,9,0,9
2020-07-03,West Coast,0,4,1,5
2020-07-03,Waitemata,0,233,4,237
2020-07-03,Wairarapa,0,8,0,8
2020-07-03,Waikato,0,187,1,188
2020-07-03,Taranaki,0,16,0,16
2020-07-03,Tairawhiti,0,4,0,4
2020-07-03,Southern,0,214,2,216
2020-07-03,South Canterbury,0,17,0,17
2020-07-03,Northland,0,28,0,28
2020-07-03,Nelson Marlborough,0,49,0,49
2020-07-03,Mid Central,0,32,0,32
2020-07-03,Lakes,0,16,0,16
2020-07-03,Hutt Valley,0,22,0,22
2020-07-03,Hawke's Bay,0,44,0,44
2020-07-03,Counties Manukau,0,131,0,131
2020-07-03,Capital and Coast,0,93,2,95
2020-07-03,Canterbury,0,152,12,164
2020-07-03,Bay of Plenty,0,47,0,47
2020-07-03,Managed Isolation & Quarantine,18,6,0,24
2020-07-03,Total,18,1490,22,1530
2020-07-05,Auckland,0,178,0,178
2020-07-05,Whanganui,0,9,0,9
2020-07-05,West Coast,0,4,1,5
2020-07-05,Waitemata,0,233,4,237
2020-07-05,Wairarapa,0,8,0,8
2020-07-05,Waikato,0,187,1,188
2020-07-05,Taranaki,0,16,0,16
2020-07-05,Tairawhiti,0,4,0,4
2020-07-05,Southern,0,214,2,216
2020-07-05,South Canterbury,0,17,0,17
2020-07-05,Northland,0,28,0,28
2020-07-05,Nelson Marlborough,0,49,0,49
2020-07-05,Mid Central,0,32,0,32
2020-07-05,Lakes,0,16,0,16
2020-07-05,Hutt Valley,0,22,0,22
2020-07-05,Hawke's Bay,0,44,0,44
2020-07-05,Counties Manukau,0,131,0,131
2020-07-05,Capital and Coast,0,93,2,95
2020-07-05,Canterbury,0,152,12,164
2020-07-05,Bay of Plenty,0,47,0,47
2020-07-05,Managed Isolation & Quarantine,21,6,0,27
2020-07-05,Total,21,1490,22,1533
2020-07-06,Auckland,0,178,0,178
2020-07-06,Whanganui,0,9,0,9
2020-07-06,West Coast,0,4,1,5
2020-07-06,Waitemata,0,233,4,237
2020-07-06,Wairarapa,0,8,0,8
2020-07-06,Waikato,0,187,1,188
2020-07-06,Taranaki,0,16,0,16
2020-07-06,Tairawhiti,0,4,0,4
2020-07-06,Southern,0,214,2,216
2020-07-06,South Canterbury,0,17,0,17
2020-07-06,Northland,0,28,0,28
2020-07-06,Nelson Marlborough,0,49,0,49
2020-07-06,Mid Central,0,32,0,32
2020-07-06,Lakes,0,16,0,16
2020-07-06,Hutt Valley,0,22,0,22
2020-07-06,Hawke's Bay,0,44,0,44
2020-07-06,Counties Manukau,0,131,0,131
2020-07-06,Capital and Coast,0,93,2,95
2020-07-06,Canterbury,0,152,12,164
2020-07-06,Bay of Plenty,0,47,0,47
2020-07-06,Managed Isolation & Quarantine,22,6,0,28
2020-07-06,Total,22,1490,22,1534
2020-07-07,Auckland,0,178,0,178
2020-07-07,Whanganui,0,9,0,9
2020-07-07,West Coast,0,4,1,5
2020-07-07,Waitemata,0,233,4,237
2020-07-07,Wairarapa,0,8,0,8
2020-07-07,Waikato,0,187,1,188
2020-07-07,Taranaki,0,16,0,16
2020-07-07,Tairawhiti,0,4,0,4
2020-07-07,Southern,0,214,2,216
2020-07-07,South Canterbury,0,17,0,17
2020-07-07,Northland,0,28,0,28
2020-07-07,Nelson Marlborough,0,49,0,49
2020-07-07,Mid Central,0,32,0,32
2020-07-07,Lakes,0,16,0,16
2020-07-07,Hutt Valley,0,22,0,22
2020-07-07,Hawke's Bay,0,44,0,44
2020-07-07,Counties Manukau,0,131,0,131
2020-07-07,Capital and Coast,0,93,2,95
2020-07-07,Canterbury,0,152,12,164
2020-07-07,Bay of Plenty,0,47,0,47
2020-07-07,Managed Isolation & Quarantine,22,8,0,30
2020-07-07,Total,22,1492,22,1536
2020-07-08,Auckland,0,178,0,178
2020-07-08,Whanganui,0,9,0,9
2020-07-08,West Coast,0,4,1,5
2020-07-08,Waitemata,0,233,4,237
2020-07-08,Wairarapa,0,8,0,8
2020-07-08,Waikato,0,187,1,188
2020-07-08,Taranaki,0,16,0,16
2020-07-08,Tairawhiti,0,4,0,4
2020-07-08,Southern,0,214,2,216
2020-07-08,South Canterbury,0,17,0,17
2020-07-08,Northland,0,28,0,28
2020-07-08,Nelson Marlborough,0,49,0,49
2020-07-08,Mid Central,0,32,0,32
2020-07-08,Lakes,0,16,0,16
2020-07-08,Hutt Valley,0,22,0,22
2020-07-08,Hawke's Bay,0,44,0,44
2020-07-08,Counties Manukau,0,131,0,131
2020-07-08,Capital and Coast,0,93,2,95
2020-07-08,Canterbury,0,152,12,164
2020-07-08,Bay of Plenty,0,47,0,47
2020-07-08,Managed Isolation & Quarantine,23,8,0,31
2020-07-08,Total,23,1492,22,1537
2020-07-09,Auckland,0,178,0,178
2020-07-09,Whanganui,0,9,0,9
2020-07-09,West Coast,0,4,1,5
2020-07-09,Waitemata,0,233,4,237
2020-07-09,Wairarapa,0,8,0,8
2020-07-09,Waikato,0,187,1,188
2020-07-09,Taranaki,0,16,0,16
2020-07-09,Tairawhiti,0,4,0,4
2020-07-09,Southern,0,214,2,216
2020-07-09,South Canterbury,0,17,0,17
2020-07-09,Northland,0,28,0,28
2020-07-09,Nelson Marlborough,0,49,0,49
2020-07-09,Mid Central,0,32,0,32
2020-07-09,Lakes,0,16,0,16
2020-07-09,Hutt Valley,0,22,0,22
2020-07-09,Hawke's Bay,0,44,0,44
2020-07-09,Counties Manukau,0,131,0,131
2020-07-09,Capital and Coast,0,93,2,95
2020-07-09,Canterbury,0,152,12,164
2020-07-09,Bay of Plenty,0,47,0,47
2020-07-09,Managed Isolation & Quarantine,24,10,0,34
2020-07-09,Total,24,1494,22,1540
2020-07-10,Auckland,0,178,0,178
2020-07-10,Whanganui,0,9,0,9
2020-07-10,West Coast,0,4,1,5
2020-07-10,Waitemata,0,233,4,237
2020-07-10,Wairarapa,0,8,0,8
2020-07-10,Waikato,0,187,1,188
2020-07-10,Taranaki,0,16,0,16
2020-07-10,Tairawhiti,0,4,0,4
2020-07-10,Southern,0,214,2,216
2020-07-10,South Canterbury,0,17,0,17
2020-07-10,Northland,0,28,0,28
2020-07-10,Nelson Marlborough,0,49,0,49
2020-07-10,Mid Central,0,32,0,32
2020-07-10,Lakes,0,16,0,16
2020-07-10,Hutt Valley,0,22,0,22
2020-07-10,Hawke's Bay,0,44,0,44
2020-07-10,Counties Manukau,0,131,0,131
2020-07-10,Capital and Coast,0,93,2,95
2020-07-10,Canterbury,0,152,12,164
2020-07-10,Bay of Plenty,0,47,0,47
2020-07-10,Managed Isolation & Quarantine,23,13,0,36
2020-07-10,Total,23,1497,22,1542
2020-07-11,Auckland,0,178,0,178
2020-07-11,Whanganui,0,9,0,9
2020-07-11,West Coast,0,4,1,5
2020-07-11,Waitemata,0,233,4,237
2020-07-11,Wairarapa,0,8,0,8
2020-07-11,Waikato,0,187,1,188
2020-07-11,Taranaki,0,16,0,16
2020-07-11,Tairawhiti,0,4,0,4
2020-07-11,Southern,0,214,2,216
2020-07-11,South Canterbury,0,17,0,17
2020-07-11,Northland,0,28,0,28
2020-07-11,Nelson Marlborough,0,49,0,49
2020-07-11,Mid Central,0,32,0,32
2020-07-11,Lakes,0,16,0,16
2020-07-11,Hutt Valley,0,22,0,22
2020-07-11,Hawke's Bay,0,44,0,44
2020-07-11,Counties Manukau,0,131,0,131
2020-07-11,Capital and Coast,0,93,2,95
2020-07-11,Canterbury,0,152,12,164
2020-07-11,Bay of Plenty,0,47,0,47
2020-07-11,Managed Isolation & Quarantine,24,13,0,37
2020-07-11,Total,24,1497,22,1543
2020-07-12,Auckland,0,178,0,178
2020-07-12,Whanganui,0,9,0,9
2020-07-12,West Coast,0,4,1,5
2020-07-12,Waitemata,0,233,4,237
2020-07-12,Wairarapa,0,8,0,8
2020-07-12,Waikato,0,187,1,188
2020-07-12,Taranaki,0,16,0,16
2020-07-12,Tairawhiti,0,4,0,4
2020-07-12,Southern,0,214,2,216
2020-07-12,South Canterbury,0,17,0,17
2020-07-12,Northland,0,28,0,28
2020-07-12,Nelson Marlborough,0,49,0,49
2020-07-12,Mid Central,0,32,0,32
2020-07-12,Lakes,0,16,0,16
2020-07-12,Hutt Valley,0,22,0,22
2020-07-12,Hawke's Bay,0,44,0,44
2020-07-12,Counties Manukau,0,131,0,131
2020-07-12,Capital and Coast,0,93,2,95
2020-07-12,Canterbury,0,152,12,164
2020-07-12,Bay of Plenty,0,47,0,47
2020-07-12,Managed Isolation & Quarantine,25,13,0,38
2020-07-12,Total,25,1497,22,1544
2020-07-13,Auckland,0,178,0,178
2020-07-13,Whanganui,0,9,0,9
2020-07-13,West Coast,0,4,1,5
2020-07-13,Waitemata,0,233,4,237
2020-07-13,Wairarapa,0,8,0,8
2020-07-13,Waikato,0,187,1,188
2020-07-13,Taranaki,0,16,0,16
2020-07-13,Tairawhiti,0,4,0,4
2020-07-13,Southern,0,214,2,216
2020-07-13,South Canterbury,0,17,0,17
2020-07-13,Northland,0,28,0,28
2020-07-13,Nelson Marlborough,0,49,0,49
2020-07-13,Mid Central,0,32,0,32
2020-07-13,Lakes,0,16,0,16
2020-07-13,Hutt Valley,0,22,0,22
2020-07-13,Hawke's Bay,0,44,0,44
2020-07-13,Counties Manukau,0,131,0,131
2020-07-13,Capital and Coast,0,93,2,95
2020-07-13,Canterbury,0,152,12,164
2020-07-13,Bay of Plenty,0,47,0,47
2020-07-13,Managed Isolation & Quarantine,25,13,0,38
2020-07-13,Total,25,1497,22,1544
2020-07-14,Auckland,0,178,0,178
2020-07-14,Whanganui,0,9,0,9
2020-07-14,West Coast,0,4,1,5
2020-07-14,Waitemata,0,233,4,237
2020-07-14,Wairarapa,0,8,0,8
2020-07-14,Waikato,0,187,1,188
2020-07-14,Taranaki,0,16,0,16
2020-07-14,Tairawhiti,0,4,0,4
2020-07-14,Southern,0,214,2,216
2020-07-14,South Canterbury,0,17,0,17
2020-07-14,Northland,0,28,0,28
2020-07-14,Nelson Marlborough,0,49,0,49
2020-07-14,Mid Central,0,32,0,32
2020-07-14,Lakes,0,16,0,16
2020-07-14,Hutt Valley,0,22,0,22
2020-07-14,Hawke's Bay,0,44,0,44
2020-07-14,Counties Manukau,0,131,0,131
2020-07-14,Capital and Coast,0,93,2,95
2020-07-14,Canterbury,0,152,12,164
2020-07-14,Bay of Plenty,0,47,0,47
2020-07-14,Managed Isolation & Quarantine,25,14,0,39
2020-07-14,Total,25,1498,22,1545
2020-07-15,Auckland,0,178,0,178
2020-07-15,Whanganui,0,9,0,9
2020-07-15,West Coast,0,4,1,5
2020-07-15,Waitemata,0,233,4,237
2020-07-15,Wairarapa,0,8,0,8
2020-07-15,Waikato,0,187,1,188
2020-07-15,Taranaki,0,16,0,16
2020-07-15,Tairawhiti,0,4,0,4
2020-07-15,Southern,0,214,2,216
2020-07-15,South Canterbury,0,17,0,17
2020-07-15,Northland,0,28,0,28
2020-07-15,Nelson Marlborough,0,49,0,49
2020-07-15,Mid Central,0,32,0,32
2020-07-15,Lakes,0,16,0,16
2020-07-15,Hutt Valley,0,22,0,22
2020-07-15,Hawke's Bay,0,44,0,44
2020-07-15,Counties Manukau,0,131,0,131
2020-07-15,Capital and Coast,0,93,2,95
2020-07-15,Canterbury,0,152,12,164
2020-07-15,Bay of Plenty,0,47,0,47
2020-07-15,Managed Isolation & Quarantine,27,14,0,41
2020-07-15,Total,27,1498,22,1547
2020-07-16,Auckland,0,178,0,178
2020-07-16,Whanganui,0,9,0,9
2020-07-16,West Coast,0,4,1,5
2020-07-16,Waitemata,0,233,4,237
2020-07-16,Wairarapa,0,8,0,8
2020-07-16,Waikato,0,187,1,188
2020-07-16,Taranaki,0,16,0,16
2020-07-16,Tairawhiti,0,4,0,4
2020-07-16,Southern,0,214,2,216
2020-07-16,South Canterbury,0,17,0,17
2020-07-16,Northland,0,28,0,28
2020-07-16,Nelson Marlborough,0,49,0,49
2020-07-16,Mid Central,0,32,0,32
2020-07-16,Lakes,0,16,0,16
2020-07-16,Hutt Valley,0,22,0,22
2020-07-16,Hawke's Bay,0,44,0,44
2020-07-16,Counties Manukau,0,131,0,131
2020-07-16,Capital and Coast,0,93,2,95
2020-07-16,Canterbury,0,152,12,164
2020-07-16,Bay of Plenty,0,47,0,47
2020-07-16,Managed Isolation & Quarantine,27,15,0,42
2020-07-16,Total,27,1499,22,1548
2020-07-17,Auckland,0,178,0,178
2020-07-17,Whanganui,0,9,0,9
2020-07-17,West Coast,0,4,1,5
2020-07-17,Waitemata,0,233,4,237
2020-07-17,Wairarapa,0,8,0,8
2020-07-17,Waikato,0,187,1,188
2020-07-17,Taranaki,0,16,0,16
2020-07-17,Tairawhiti,0,4,0,4
2020-07-17,Southern,0,214,2,216
2020-07-17,South Canterbury,0,17,0,17
2020-07-17,Northland,0,28,0,28
2020-07-17,Nelson Marlborough,0,49,0,49
2020-07-17,Mid Central,0,32,0,32
2020-07-17,Lakes,0,16,0,16
2020-07-17,Hutt Valley,0,22,0,22
2020-07-17,Hawke's Bay,0,44,0,44
2020-07-17,Counties Manukau,0,131,0,131
2020-07-17,Capital and Coast,0,93,2,95
2020-07-17,Canterbury,0,152,12,164
2020-07-17,Bay of Plenty,0,47,0,47
2020-07-17,Managed Isolation & Quarantine,21,22,0,43
2020-07-17,Total,21,1506,22,1549
2020-07-18,Auckland,0,178,0,178
2020-07-18,Whanganui,0,9,0,9
2020-07-18,West Coast,0,4,1,5
2020-07-18,Waitemata,0,233,4,237
2020-07-18,Wairarapa,0,8,0,8
2020-07-18,Waikato,0,187,1,188
2020-07-18,Taranaki,0,16,0,16
2020-07-18,Tairawhiti,0,4,0,4
2020-07-18,Southern,0,214,2,216
2020-07-18,South Canterbury,0,17,0,17
2020-07-18,Northland,0,28,0,28
2020-07-18,Nelson Marlborough,0,49,0,49
2020-07-18,Mid Central,0,32,0,32
2020-07-18,Lakes,0,16,0,16
2020-07-18,Hutt Valley,0,22,0,22
2020-07-18,Hawke's Bay,0,44,0,44
2020-07-18,Counties Manukau,0,131,0,131
2020-07-18,Capital and Coast,0,93,2,95
2020-07-18,Canterbury,0,152,12,164
2020-07-18,Bay of Plenty,0,47,0,47
2020-07-18,Managed Isolation & Quarantine,22,22,0,44
2020-07-18,Total,22,1506,22,1550
2020-07-19,Auckland,0,178,0,178
2020-07-19,Whanganui,0,9,0,9
2020-07-19,West Coast,0,4,1,5
2020-07-19,Waitemata,0,233,4,237
2020-07-19,Wairarapa,0,8,0,8
2020-07-19,Waikato,0,187,1,188
2020-07-19,Taranaki,0,16,0,16
2020-07-19,Tairawhiti,0,4,0,4
2020-07-19,Southern,0,214,2,216
2020-07-19,South Canterbury,0,17,0,17
2020-07-19,Northland,0,28,0,28
2020-07-19,Nelson Marlborough,0,49,0,49
2020-07-19,Mid Central,0,32,0,32
2020-07-19,Lakes,0,16,0,16
2020-07-19,Hutt Valley,0,22,0,22
2020-07-19,Hawke's Bay,0,44,0,44
2020-07-19,Counties Manukau,0,131,0,131
2020-07-19,Capital and Coast,0,93,2,95
2020-07-19,Canterbury,0,152,12,164
2020-07-19,Bay of Plenty,0,47,0,47
2020-07-19,Managed Isolation & Quarantine,25,22,0,47
2020-07-19,Total,25,1506,22,1553
2020-07-20,Auckland,0,178,0,178
2020-07-20,Whanganui,0,9,0,9
2020-07-20,West Coast,0,4,1,5
2020-07-20,Waitemata,0,233,4,237
2020-07-20,Wairarapa,0,8,0,8
2020-07-20,Waikato,0,187,1,188
2020-07-20,Taranaki,0,16,0,16
2020-07-20,Tairawhiti,0,4,0,4
2020-07-20,Southern,0,214,2,216
2020-07-20,South Canterbury,0,17,0,17
2020-07-20,Northland,0,28,0,28
2020-07-20,Nelson Marlborough,0,49,0,49
2020-07-20,Mid Central,0,32,0,32
2020-07-20,Lakes,0,16,0,16
2020-07-20,Hutt Valley,0,22,0,22
2020-07-20,Hawke's Bay,0,44,0,44
2020-07-20,Counties Manukau,0,131,0,131
2020-07-20,Capital and Coast,0,93,2,95
2020-07-20,Canterbury,0,152,12,164
2020-07-20,Bay of Plenty,0,47,0,47
2020-07-20,Managed Isolation & Quarantine,26,22,0,48
2020-07-20,Total,26,1506,22,1554
2020-07-21,Auckland,0,178,0,178
2020-07-21,Whanganui,0,9,0,9
2020-07-21,West Coast,0,4,1,5
2020-07-21,Waitemata,0,233,4,237
2020-07-21,Wairarapa,0,8,0,8
2020-07-21,Waikato,0,187,1,188
2020-07-21,Taranaki,0,16,0,16
2020-07-21,Tairawhiti,0,4,0,4
2020-07-21,Southern,0,214,2,216
2020-07-21,South Canterbury,0,17,0,17
2020-07-21,Northland,0,28,0,28
2020-07-21,Nelson Marlborough,0,49,0,49
2020-07-21,Mid Central,0,32,0,32
2020-07-21,Lakes,0,16,0,16
2020-07-21,Hutt Valley,0,22,0,22
2020-07-21,Hawke's Bay,0,44,0,44
2020-07-21,Counties Manukau,0,131,0,131
2020-07-21,Capital and Coast,0,93,2,95
2020-07-21,Canterbury,0,152,12,164
2020-07-21,Bay of Plenty,0,47,0,47
2020-07-21,Managed Isolation & Quarantine,27,22,0,48
2020-07-21,Total,27,1506,22,1555
2020-07-22,Auckland,0,178,0,178
2020-07-22,Whanganui,0,9,0,9
2020-07-22,West Coast,0,4,1,5
2020-07-22,Waitemata,0,233,4,237
2020-07-22,Wairarapa,0,8,0,8
2020-07-22,Waikato,0,187,1,188
2020-07-22,Taranaki,0,16,0,16
2020-07-22,Tairawhiti,0,4,0,4
2020-07-22,Southern,0,214,2,216
2020-07-22,South Canterbury,0,17,0,17
2020-07-22,Northland,0,28,0,28
2020-07-22,Nelson Marlborough,0,49,0,49
2020-07-22,Mid Central,0,32,0,32
2020-07-22,Lakes,0,16,0,16
2020-07-22,Hutt Valley,0,22,0,22
2020-07-22,Hawke's Bay,0,44,0,44
2020-07-22,Counties Manukau,0,131,0,131
2020-07-22,Capital and Coast,0,93,2,95
2020-07-22,Canterbury,0,152,12,164
2020-07-22,Bay of Plenty,0,47,0,47
2020-07-22,Managed Isolation & Quarantine,27,22,0,48
2020-07-22,Total,27,1506,22,1555
2020-07-23,Auckland,0,178,0,178
2020-07-23,Whanganui,0,9,0,9
2020-07-23,West Coast,0,4,1,5
2020-07-23,Waitemata,0,233,4,237
2020-07-23,Wairarapa,0,8,0,8
2020-07-23,Waikato,0,187,1,188
2020-07-23,Taranaki,0,16,0,16
2020-07-23,Tairawhiti,0,4,0,4
2020-07-23,Southern,0,214,2,216
2020-07-23,South Canterbury,0,17,0,17
2020-07-23,Northland,0,28,0,28
2020-07-23,Nelson Marlborough,0,49,0,49
2020-07-23,Mid Central,0,32,0,32
2020-07-23,Lakes,0,16,0,16
2020-07-23,Hutt Valley,0,22,0,22
2020-07-23,Hawke's Bay,0,44,0,44
2020-07-23,Counties Manukau,0,131,0,131
2020-07-23,Capital and Coast,0,93,2,95
2020-07-23,Canterbury,0,152,12,164
2020-07-23,Bay of Plenty,0,47,0,47
2020-07-23,Managed Isolation & Quarantine,22,27,0,49
2020-07-23,Total,22,1511,22,1555
2020-07-24,Auckland,0,178,0,178
2020-07-24,Whanganui,0,9,0,9
2020-07-24,West Coast,0,4,1,5
2020-07-24,Waitemata,0,233,4,237
2020-07-24,Wairarapa,0,8,0,8
2020-07-24,Waikato,0,187,1,188
2020-07-24,Taranaki,0,16,0,16
2020-07-24,Tairawhiti,0,4,0,4
2020-07-24,Southern,0,214,2,216
2020-07-24,South Canterbury,0,17,0,17
2020-07-24,Northland,0,28,0,28
2020-07-24,Nelson Marlborough,0,49,0,49
2020-07-24,Mid Central,0,32,0,32
2020-07-24,Lakes,0,16,0,16
2020-07-24,Hutt Valley,0,22,0,22
2020-07-24,Hawke's Bay,0,44,0,44
2020-07-24,Counties Manukau,0,131,0,131
2020-07-24,Capital and Coast,0,93,2,95
2020-07-24,Canterbury,0,152,12,164
2020-07-24,Bay of Plenty,0,47,0,47
2020-07-24,Managed Isolation & Quarantine,21,29,0,50
2020-07-24,Total,21,1513,22,1556
2020-07-25,Auckland,0,178,0,178
2020-07-25,Whanganui,0,9,0,9
2020-07-25,West Coast,0,4,1,5
2020-07-25,Waitemata,0,233,4,237
2020-07-25,Wairarapa,0,8,0,8
2020-07-25,Waikato,0,187,1,188
2020-07-25,Taranaki,0,16,0,16
2020-07-25,Tairawhiti,0,4,0,4
2020-07-25,Southern,0,214,2,216
2020-07-25,South Canterbury,0,17,0,17
2020-07-25,Northland,0,28,0,28
2020-07-25,Nelson Marlborough,0,49,0,49
2020-07-25,Mid Central,0,32,0,32
2020-07-25,Lakes,0,16,0,16
2020-07-25,Hutt Valley,0,22,0,22
2020-07-25,Hawke's Bay,0,44,0,44
2020-07-25,Counties Manukau,0,131,0,131
2020-07-25,Capital and Coast,0,93,2,95
2020-07-25,Canterbury,0,152,12,164
2020-07-25,Bay of Plenty,0,47,0,47
2020-07-25,Managed Isolation & Quarantine,21,29,0,50
2020-07-25,Total,21,1513,22,1556
2020-07-26,Auckland,0,176,0,176
2020-07-26,Whanganui,0,9,0,9
2020-07-26,West Coast,0,4,1,5
2020-07-26,Waitemata,0,234,4,238
2020-07-26,Wairarapa,0,8,0,8
2020-07-26,Waikato,0,187,1,188
2020-07-26,Taranaki,0,16,0,16
2020-07-26,Tairawhiti,0,4,0,4
2020-07-26,Southern,0,214,2,216
2020-07-26,South Canterbury,0,17,0,17
2020-07-26,Northland,0,28,0,28
2020-07-26,Nelson Marlborough,0,49,0,49
2020-07-26,Mid Central,0,32,0,32
2020-07-26,Lakes,0,16,0,16
2020-07-26,Hutt Valley,0,22,0,22
2020-07-26,Hawke's Bay,0,44,0,44
2020-07-26,Counties Manukau,0,132,0,132
2020-07-26,Capital and Coast,0,93,2,95
2020-07-26,Canterbury,0,152,12,164
2020-07-26,Bay of Plenty,0,47,0,47
2020-07-26,Managed Isolation & Quarantine,21,29,0,50
2020-07-26,Total,21,1513,22,1556
2020-07-28,Auckland,0,176,0,176
2020-07-28,Whanganui,0,9,0,9
2020-07-28,West Coast,0,4,1,5
2020-07-28,Waitemata,0,234,4,238
2020-07-28,Wairarapa,0,8,0,8
2020-07-28,Waikato,0,187,1,188
2020-07-28,Taranaki,0,16,0,16
2020-07-28,Tairawhiti,0,4,0,4
2020-07-28,Southern,0,214,2,216
2020-07-28,South Canterbury,0,17,0,17
2020-07-28,Northland,0,28,0,28
2020-07-28,Nelson Marlborough,0,49,0,49
2020-07-28,Mid Central,0,32,0,32
2020-07-28,Lakes,0,16,0,16
2020-07-28,Hutt Valley,0,22,0,22
2020-07-28,Hawke's Bay,0,44,0,44
2020-07-28,Counties Manukau,0,132,0,132
2020-07-28,Capital and Coast,0,93,2,95
2020-07-28,Canterbury,0,152,12,164
2020-07-28,Bay of Plenty,0,47,0,47
2020-07-28,Managed Isolation & Quarantine,21,30,0,51
2020-07-28,Total,21,1514,22,1557
2020-07-29,Auckland,0,176,0,176
2020-07-29,Whanganui,0,9,0,9
2020-07-29,West Coast,0,4,1,5
2020-07-29,Waitemata,0,234,4,238
2020-07-29,Wairarapa,0,8,0,8
2020-07-29,Waikato,0,187,1,188
2020-07-29,Taranaki,0,16,0,16
2020-07-29,Tairawhiti,0,4,0,4
2020-07-29,Southern,0,214,2,216
2020-07-29,South Canterbury,0,17,0,17
2020-07-29,Northland,0,28,0,28
2020-07-29,Nelson Marlborough,0,49,0,49
2020-07-29,Mid Central,0,32,0,32
2020-07-29,Lakes,0,16,0,16
2020-07-29,Hutt Valley,0,22,0,22
2020-07-29,Hawke's Bay,0,44,0,44
2020-07-29,Counties Manukau,0,132,0,132
2020-07-29,Capital and Coast,0,93,2,95
2020-07-29,Canterbury,0,152,12,164
2020-07-29,Bay of Plenty,0,47,0,47
2020-07-29,Managed Isolation & Quarantine,23,30,0,53
2020-07-29,Total,23,1514,22,1559
2020-07-30,Auckland,0,176,0,176
2020-07-30,Whanganui,0,9,0,9
2020-07-30,West Coast,0,4,1,5
2020-07-30,Waitemata,0,234,4,238
2020-07-30,Wairarapa,0,8,0,8
2020-07-30,Waikato,0,187,1,188
2020-07-30,Taranaki,0,16,0,16
2020-07-30,Tairawhiti,0,4,0,4
2020-07-30,Southern,0,214,2,216
2020-07-30,South Canterbury,0,17,0,17
2020-07-30,Northland,0,28,0,28
2020-07-30,Nelson Marlborough,0,49,0,49
2020-07-30,Mid Central,0,32,0,32
2020-07-30,Lakes,0,16,0,16
2020-07-30,Hutt Valley,0,22,0,22
2020-07-30,Hawke's Bay,0,44,0,44
2020-07-30,Counties Manukau,0,132,0,132
2020-07-30,Capital and Coast,0,93,2,95
2020-07-30,Canterbury,0,152,12,164
2020-07-30,Bay of Plenty,0,47,0,47
2020-07-30,Managed Isolation & Quarantine,24,30,0,54
2020-07-30,Total,24,1514,22,1560
2020-07-31,Auckland,0,176,0,176
2020-07-31,Whanganui,0,9,0,9
2020-07-31,West Coast,0,4,1,5
2020-07-31,Waitemata,0,234,4,238
2020-07-31,Wairarapa,0,8,0,8
2020-07-31,Waikato,0,187,1,188
2020-07-31,Taranaki,0,16,0,16
2020-07-31,Tairawhiti,0,4,0,4
2020-07-31,Southern,0,214,2,216
2020-07-31,South Canterbury,0,17,0,17
2020-07-31,Northland,0,28,0,28
2020-07-31,Nelson Marlborough,0,49,0,49
2020-07-31,Mid Central,0,32,0,32
2020-07-31,Lakes,0,16,0,16
2020-07-31,Hutt Valley,0,22,0,22
2020-07-31,Hawke's Bay,0,44,0,44
2020-07-31,Counties Manukau,0,132,0,132
2020-07-31,Capital and Coast,0,93,2,95
2020-07-31,Canterbury,0,152,12,164
2020-07-31,Bay of Plenty,0,47,0,47
2020-07-31,Managed Isolation & Quarantine,20,34,0,54
2020-07-31,Total,20,1518,22,1560
2020-08-01,Auckland,0,176,0,176
2020-08-01,Whanganui,0,9,0,9
2020-08-01,West Coast,0,4,1,5
2020-08-01,Waitemata,0,234,4,238
2020-08-01,Wairarapa,0,8,0,8
2020-08-01,Waikato,0,187,1,188
2020-08-01,Taranaki,0,16,0,16
2020-08-01,Tairawhiti,0,4,0,4
2020-08-01,Southern,0,214,2,216
2020-08-01,South Canterbury,0,17,0,17
2020-08-01,Northland,0,28,0,28
2020-08-01,Nelson Marlborough,0,49,0,49
2020-08-01,Mid Central,0,32,0,32
2020-08-01,Lakes,0,16,0,16
2020-08-01,Hutt Valley,0,22,0,22
2020-08-01,Hawke's Bay,0,44,0,44
2020-08-01,Counties Manukau,0,132,0,132
2020-08-01,Capital and Coast,0,93,2,95
2020-08-01,Canterbury,0,152,12,164
2020-08-01,Bay of Plenty,0,47,0,47
2020-08-01,Managed Isolation & Quarantine,22,34,0,56
2020-08-01,Total,22,1518,22,1562
2020-08-02,Auckland,0,176,0,176
2020-08-02,Whanganui,0,9,0,9
2020-08-02,West Coast,0,4,1,5
2020-08-02,Waitemata,0,234,4,238
2020-08-02,Wairarapa,0,8,0,8
2020-08-02,Waikato,0,187,1,188
2020-08-02,Taranaki,0,16,0,16
2020-08-02,Tairawhiti,0,4,0,4
2020-08-02,Southern,0,214,2,216
2020-08-02,South Canterbury,0,17,0,17
2020-08-02,Northland,0,28,0,28
2020-08-02,Nelson Marlborough,0,49,0,49
2020-08-02,Mid Central,0,32,0,32
2020-08-02,Lakes,0,16,0,16
2020-08-02,Hutt Valley,0,22,0,22
2020-08-02,Hawke's Bay,0,44,0,44
2020-08-02,Counties Manukau,0,132,0,132
2020-08-02,Capital and Coast,0,93,2,95
2020-08-02,Canterbury,0,152,12,164
2020-08-02,Bay of Plenty,0,47,0,47
2020-08-02,Managed Isolation & Quarantine,25,34,0,59
2020-08-02,Total,25,1518,22,1565
2020-08-03,Auckland,0,176,0,176
2020-08-03,Whanganui,0,9,0,9
2020-08-03,West Coast,0,4,1,5
2020-08-03,Waitemata,0,234,4,238
2020-08-03,Wairarapa,0,8,0,8
2020-08-03,Waikato,0,187,1,188
2020-08-03,Taranaki,0,16,0,16
2020-08-03,Tairawhiti,0,4,0,4
2020-08-03,Southern,0,214,2,216
2020-08-03,South Canterbury,0,17,0,17
2020-08-03,Northland,0,28,0,28
2020-08-03,Nelson Marlborough,0,49,0,49
2020-08-03,Mid Central,0,32,0,32
2020-08-03,Lakes,0,16,0,16
2020-08-03,Hutt Valley,0,22,0,22
2020-08-03,Hawke's Bay,0,44,0,44
2020-08-03,Counties Manukau,0,132,0,132
2020-08-03,Capital and Coast,0,93,2,95
2020-08-03,Canterbury,0,152,12,164
2020-08-03,Bay of Plenty,0,47,0,47
2020-08-03,Managed Isolation & Quarantine,27,34,0,61
2020-08-03,Total,27,1518,22,1567
2020-08-04,Auckland,0,176,0,176
2020-08-04,Whanganui,0,9,0,9
2020-08-04,West Coast,0,4,1,5
2020-08-04,Waitemata,0,234,4,238
2020-08-04,Wairarapa,0,8,0,8
2020-08-04,Waikato,0,187,1,188
2020-08-04,Taranaki,0,16,0,16
2020-08-04,Tairawhiti,0,4,0,4
2020-08-04,Southern,0,214,2,216
2020-08-04,South Canterbury,0,17,0,17
2020-08-04,Northland,0,28,0,28
2020-08-04,Nelson Marlborough,0,49,0,49
2020-08-04,Mid Central,0,32,0,32
2020-08-04,Lakes,0,16,0,16
2020-08-04,Hutt Valley,0,22,0,22
2020-08-04,Hawke's Bay,0,44,0,44
2020-08-04,Counties Manukau,0,132,0,132
2020-08-04,Capital and Coast,0,93,2,95
2020-08-04,Canterbury,0,152,12,164
2020-08-04,Bay of Plenty,0,47,0,47
2020-08-04,Managed Isolation & Quarantine,22,39,0,61
2020-08-04,Total,22,1523,22,1567
2020-08-05,Auckland,0,176,0,176
2020-08-05,Whanganui,0,9,0,9
2020-08-05,West Coast,0,4,1,5
2020-08-05,Waitemata,0,234,4,238
2020-08-05,Wairarapa,0,8,0,8
2020-08-05,Waikato,0,187,1,188
2020-08-05,Taranaki,0,16,0,16
2020-08-05,Tairawhiti,0,4,0,4
2020-08-05,Southern,0,214,2,216
2020-08-05,South Canterbury,0,17,0,17
2020-08-05,Northland,0,28,0,28
2020-08-05,Nelson Marlborough,0,49,0,49
2020-08-05,Mid Central,0,32,0,32
2020-08-05,Lakes,0,16,0,16
2020-08-05,Hutt Valley,0,22,0,22
2020-08-05,Hawke's Bay,0,44,0,44
2020-08-05,Counties Manukau,0,132,0,132
2020-08-05,Capital and Coast,0,93,2,95
2020-08-05,Canterbury,0,152,12,164
2020-08-05,Bay of Plenty,0,47,0,47
2020-08-05,Managed Isolation & Quarantine,24,39,0,63
2020-08-05,Total,24,1523,22,1569
2020-08-06,Auckland,0,176,0,176
2020-08-06,Whanganui,0,9,0,9
2020-08-06,West Coast,0,4,1,5
2020-08-06,Waitemata,0,234,4,238
2020-08-06,Wairarapa,0,8,0,8
2020-08-06,Waikato,0,187,1,188
2020-08-06,Taranaki,0,16,0,16
2020-08-06,Tairawhiti,0,4,0,4
2020-08-06,Southern,0,214,2,216
2020-08-06,South Canterbury,0,17,0,17
2020-08-06,Northland,0,28,0,28
2020-08-06,Nelson Marlborough,0,49,0,49
2020-08-06,Mid Central,0,32,0,32
2020-08-06,Lakes,0,16,0,16
2020-08-06,Hutt Valley,0,22,0,22
2020-08-06,Hawke's Bay,0,44,0,44
2020-08-06,Counties Manukau,0,132,0,132
2020-08-06,Capital and Coast,0,93,2,95
2020-08-06,Canterbury,0,152,12,164
2020-08-06,Bay of Plenty,0,47,0,47
2020-08-06,Managed Isolation & Quarantine,23,40,0,63
2020-08-06,Total,23,1524,22,1569
2020-08-10,Auckland,0,176,0,176
2020-08-10,Whanganui,0,9,0,9
2020-08-10,West Coast,0,4,1,5
2020-08-10,Waitemata,0,234,4,238
2020-08-10,Wairarapa,0,8,0,8
2020-08-10,Waikato,0,187,1,188
2020-08-10,Taranaki,0,16,0,16
2020-08-10,Tairawhiti,0,4,0,4
2020-08-10,Southern,0,214,2,216
2020-08-10,South Canterbury,0,17,0,17
2020-08-10,Northland,0,28,0,28
2020-08-10,Nelson Marlborough,0,49,0,49
2020-08-10,Mid Central,0,32,0,32
2020-08-10,Lakes,0,16,0,16
2020-08-10,Hutt Valley,0,22,0,22
2020-08-10,Hawke's Bay,0,44,0,44
2020-08-10,Counties Manukau,0,132,0,132
2020-08-10,Capital and Coast,0,93,2,95
2020-08-10,Canterbury,0,152,12,164
2020-08-10,Bay of Plenty,0,47,0,47
2020-08-10,Managed Isolation & Quarantine,21,42,0,63
2020-08-10,Total,21,1526,22,1569
2020-08-11,Auckland,0,176,0,176
2020-08-11,Whanganui,0,9,0,9
2020-08-11,West Coast,0,4,1,5
2020-08-11,Waitemata,0,234,4,238
2020-08-11,Wairarapa,0,8,0,8
2020-08-11,Waikato,0,187,1,188
2020-08-11,Taranaki,0,16,0,16
2020-08-11,Tairawhiti,0,4,0,4
2020-08-11,Southern,0,214,2,216
2020-08-11,South Canterbury,0,17,0,17
2020-08-11,Northland,0,28,0,28
2020-08-11,Nelson Marlborough,0,49,0,49
2020-08-11,Mid Central,0,32,0,32
2020-08-11,Lakes,0,16,0,16
2020-08-11,Hutt Valley,0,22,0,22
2020-08-11,Hawke's Bay,0,44,0,44
2020-08-11,Counties Manukau,0,132,0,132
2020-08-11,Capital and Coast,0,93,2,95
2020-08-11,Canterbury,0,152,12,164
2020-08-11,Bay of Plenty,0,47,0,47
2020-08-11,Managed Isolation & Quarantine,22,42,0,64
2020-08-11,Total,22,1526,22,1570
2020-08-12,Auckland,0,176,0,176
2020-08-12,Whanganui,0,9,0,9
2020-08-12,West Coast,0,4,1,5
2020-08-12,Waitemata,2,234,4,240
2020-08-12,Wairarapa,0,8,0,8
2020-08-12,Waikato,0,187,1,188
2020-08-12,Taranaki,0,16,0,16
2020-08-12,Tairawhiti,0,4,0,4
2020-08-12,Southern,0,214,2,216
2020-08-12,South Canterbury,0,17,0,17
2020-08-12,Northland,0,28,0,28
2020-08-12,Nelson Marlborough,0,49,0,49
2020-08-12,Mid Central,0,32,0,32
2020-08-12,Lakes,0,16,0,16
2020-08-12,Hutt Valley,0,22,0,22
2020-08-12,Hawke's Bay,0,44,0,44
2020-08-12,Counties Manukau,6,132,0,138
2020-08-12,Capital and Coast,0,93,2,95
2020-08-12,Canterbury,0,152,12,164
2020-08-12,Bay of Plenty,0,47,0,47
2020-08-12,Managed Isolation & Quarantine,18,47,0,65
2020-08-12,Total,26,1531,22,1579
2020-08-13,Auckland,1,176,0,177
2020-08-13,Whanganui,0,9,0,9
2020-08-13,West Coast,0,4,1,5
2020-08-13,Waitemata,3,233,4,240
2020-08-13,Wairarapa,0,8,0,8
2020-08-13,Waikato,0,187,1,188
2020-08-13,Taranaki,0,16,0,16
2020-08-13,Tairawhiti,0,4,0,4
2020-08-13,Southern,0,214,2,216
2020-08-13,South Canterbury,0,17,0,17
2020-08-13,Northland,0,28,0,28
2020-08-13,Nelson Marlborough,0,49,0,49
2020-08-13,Mid Central,0,32,0,32
2020-08-13,Lakes,0,16,0,16
2020-08-13,Hutt Valley,0,22,0,22
2020-08-13,Hawke's Bay,0,44,0,44
2020-08-13,Counties Manukau,13,133,0,146
2020-08-13,Capital and Coast,0,93,2,95
2020-08-13,Canterbury,0,152,12,164
2020-08-13,Bay of Plenty,0,47,0,47
2020-08-13,Managed Isolation & Quarantine,19,47,0,66
2020-08-13,Total,36,1531,22,1589
2020-08-14,Auckland,5,176,0,181
2020-08-14,Whanganui,0,9,0,9
2020-08-14,West Coast,0,4,1,5
2020-08-14,Waitemata,5,233,4,242
2020-08-14,Wairarapa,0,8,0,8
2020-08-14,Waikato,2,186,1,189
2020-08-14,Taranaki,0,16,0,16
2020-08-14,Tairawhiti,0,4,0,4
2020-08-14,Southern,0,214,2,216
2020-08-14,South Canterbury,0,17,0,17
2020-08-14,Northland,0,28,0,28
2020-08-14,Nelson Marlborough,0,49,0,49
2020-08-14,Mid Central,0,32,0,32
2020-08-14,Lakes,0,16,0,16
2020-08-14,Hutt Valley,0,22,0,22
2020-08-14,Hawke's Bay,0,44,0,44
2020-08-14,Counties Manukau,18,133,0,151
2020-08-14,Capital and Coast,0,93,2,95
2020-08-14,Canterbury,0,152,12,164
2020-08-14,Bay of Plenty,0,48,0,48
2020-08-14,Managed Isolation & Quarantine,19,47,0,66
2020-08-14,Total,49,1531,22,1602
2020-08-15,Auckland,8,176,0,184
2020-08-15,Whanganui,0,9,0,9
2020-08-15,West Coast,0,4,1,5
2020-08-15,Waitemata,6,233,4,243
2020-08-15,Wairarapa,0,8,0,8
2020-08-15,Waikato,2,186,1,189
2020-08-15,Taranaki,0,16,0,16
2020-08-15,Tairawhiti,0,4,0,4
2020-08-15,Southern,0,214,2,216
2020-08-15,South Canterbury,0,17,0,17
2020-08-15,Northland,0,28,0,28
2020-08-15,Nelson Marlborough,0,49,0,49
2020-08-15,Mid Central,0,32,0,32
2020-08-15,Lakes,0,16,0,16
2020-08-15,Hutt Valley,0,22,0,22
2020-08-15,Hawke's Bay,0,44,0,44
2020-08-15,Counties Manukau,21,133,0,154
2020-08-15,Capital and Coast,0,93,2,95
2020-08-15,Canterbury,0,152,12,164
2020-08-15,Bay of Plenty,0,48,0,48
2020-08-15,Managed Isolation & Quarantine,19,47,0,66
2020-08-15,Total,56,1531,22,1609
2020-08-16,Auckland,13,176,0,189
2020-08-16,Whanganui,0,9,0,9
2020-08-16,West Coast,0,4,1,5
2020-08-16,Waitemata,8,233,4,245
2020-08-16,Wairarapa,0,8,0,8
2020-08-16,Waikato,0,186,1,187
2020-08-16,Taranaki,0,16,0,16
2020-08-16,Tairawhiti,0,4,0,4
2020-08-16,Southern,0,214,2,216
2020-08-16,South Canterbury,0,17,0,17
2020-08-16,Northland,0,28,0,28
2020-08-16,Nelson Marlborough,0,49,0,49
2020-08-16,Mid Central,0,32,0,32
2020-08-16,Lakes,0,16,0,16
2020-08-16,Hutt Valley,0,22,0,22
2020-08-16,Hawke's Bay,0,44,0,44
2020-08-16,Counties Manukau,28,133,0,161
2020-08-16,Capital and Coast,0,93,2,95
2020-08-16,Canterbury,0,152,12,164
2020-08-16,Bay of Plenty,0,48,0,48
2020-08-16,Managed Isolation & Quarantine,20,47,0,67
2020-08-16,Total,69,1531,22,1622
2020-08-17,Northland,0,28,0,28
2020-08-17,Southern,0,214,2,216
2020-08-17,South Canterbury,0,17,0,17
2020-08-17,Canterbury,0,152,12,164
2020-08-17,West Coast,0,4,1,5
2020-08-17,Nelson Marlborough,0,49,0,49
2020-08-17,Wairarapa,0,8,0,8
2020-08-17,Capital and Coast,0,93,2,95
2020-08-17,Hutt Valley,0,22,0,22
2020-08-17,Mid Central,0,32,0,32
2020-08-17,Whanganui,0,9,0,9
2020-08-17,Hawke's Bay,0,44,0,44
2020-08-17,Taranaki,0,16,0,16
2020-08-17,Tairawhiti,0,4,0,4
2020-08-17,Bay of Plenty,0,48,0,48
2020-08-17,Lakes,0,16,0,16
2020-08-17,Waikato,0,186,1,187
2020-08-17,Counties Manukau,31,133,0,164
2020-08-17,Auckland,19,176,0,195
2020-08-17,Waitemata,8,233,4,245
2020-08-17,"Managed Isolation
			& Quarantine*",20,47,0,67
2020-08-17,Total,78,1531,22,1631
2020-08-18,Northland,0,28,0,28
2020-08-18,Southern,0,214,2,216
2020-08-18,South Canterbury,0,17,0,17
2020-08-18,Canterbury,0,152,12,164
2020-08-18,West Coast,0,4,1,5
2020-08-18,Nelson Marlborough,0,49,0,49
2020-08-18,Wairarapa,0,8,0,8
2020-08-18,Capital and Coast,0,93,2,95
2020-08-18,Hutt Valley,0,22,0,22
2020-08-18,Mid Central,0,32,0,32
2020-08-18,Whanganui,0,9,0,9
2020-08-18,Hawke's Bay,0,44,0,44
2020-08-18,Taranaki,0,16,0,16
2020-08-18,Tairawhiti,0,4,0,4
2020-08-18,Bay of Plenty,0,48,0,48
2020-08-18,Lakes,0,16,0,16
2020-08-18,Waikato,0,186,1,187
2020-08-18,Counties Manukau,31,133,0,164
2020-08-18,Auckland,19,176,0,195
2020-08-18,Waitemata,8,233,4,245
2020-08-18,Managed Isolation			& Quarantine*,20,47,0,67
2020-08-18,Total,78,1531,22,1631
2020-08-19,Auckland,25,176,0,201
2020-08-19,Whanganui,0,9,0,9
2020-08-19,West Coast,0,4,1,5
2020-08-19,Waitemata,9,233,4,246
2020-08-19,Wairarapa,0,8,0,8
2020-08-19,Waikato,0,186,1,187
2020-08-19,Taranaki,0,16,0,16
2020-08-19,Tairawhiti,0,4,0,4
2020-08-19,Southern,0,214,2,216
2020-08-19,South Canterbury,0,17,0,17
2020-08-19,Northland,0,28,0,28
2020-08-19,Nelson Marlborough,0,49,0,49
2020-08-19,Mid Central,0,32,0,32
2020-08-19,Lakes,0,16,0,16
2020-08-19,Hutt Valley,0,22,0,22
2020-08-19,Hawke's Bay,0,44,0,44
2020-08-19,Counties Manukau,41,133,0,174
2020-08-19,Capital and Coast,0,93,2,95
2020-08-19,Canterbury,0,152,12,164
2020-08-19,Bay of Plenty,0,48,0,48
2020-08-19,Managed Isolation & Quarantine,21,47,0,68
2020-08-19,Total,96,1531,22,1649
2020-08-20,Auckland,26,176,0,202
2020-08-20,Whanganui,0,9,0,9
2020-08-20,West Coast,0,4,1,5
2020-08-20,Waitemata,12,233,4,249
2020-08-20,Wairarapa,0,8,0,8
2020-08-20,Waikato,1,186,1,188
2020-08-20,Taranaki,0,16,0,16
2020-08-20,Tairawhiti,0,4,0,4
2020-08-20,Southern,0,214,2,216
2020-08-20,South Canterbury,0,17,0,17
2020-08-20,Northland,0,28,0,28
2020-08-20,Nelson Marlborough,0,49,0,49
2020-08-20,Mid Central,0,32,0,32
2020-08-20,Lakes,0,16,0,16
2020-08-20,Hutt Valley,0,22,0,22
2020-08-20,Hawke's Bay,0,44,0,44
2020-08-20,Counties Manukau,41,133,0,174
2020-08-20,Capital and Coast,0,93,2,95
2020-08-20,Canterbury,0,152,12,164
2020-08-20,Bay of Plenty,0,48,0,48
2020-08-20,Managed Isolation & Quarantine,21,47,0,68
2020-08-20,Total,101,1531,22,1654
2020-08-21,Auckland,29,176,0,205
2020-08-21,Whanganui,0,9,0,9
2020-08-21,West Coast,0,4,1,5
2020-08-21,Waitemata,14,233,4,251
2020-08-21,Wairarapa,0,8,0,8
2020-08-21,Waikato,1,186,1,188
2020-08-21,Taranaki,0,16,0,16
2020-08-21,Tairawhiti,0,4,0,4
2020-08-21,Southern,0,214,2,216
2020-08-21,South Canterbury,0,17,0,17
2020-08-21,Northland,0,28,0,28
2020-08-21,Nelson Marlborough,0,49,0,49
2020-08-21,Mid Central,0,32,0,32
2020-08-21,Lakes,0,16,0,16
2020-08-21,Hutt Valley,0,22,0,22
2020-08-21,Hawke's Bay,0,44,0,44
2020-08-21,Counties Manukau,45,133,0,178
2020-08-21,Capital and Coast,0,93,2,95
2020-08-21,Canterbury,0,152,12,164
2020-08-21,Bay of Plenty,0,48,0,48
2020-08-21,Managed Isolation & Quarantine,16,54,0,70
2020-08-21,Total,105,1538,22,1665
2020-08-22,Auckland,30,176,0,206
2020-08-22,Whanganui,0,9,0,9
2020-08-22,West Coast,0,4,1,5
2020-08-22,Waitemata,16,233,4,253
2020-08-22,Wairarapa,0,8,0,8
2020-08-22,Waikato,1,186,1,188
2020-08-22,Taranaki,0,16,0,16
2020-08-22,Tairawhiti,0,4,0,4
2020-08-22,Southern,0,214,2,216
2020-08-22,South Canterbury,0,17,0,17
2020-08-22,Northland,0,28,0,28
2020-08-22,Nelson Marlborough,0,49,0,49
2020-08-22,Mid Central,0,32,0,32
2020-08-22,Lakes,0,16,0,16
2020-08-22,Hutt Valley,0,22,0,22
2020-08-22,Hawke's Bay,0,44,0,44
2020-08-22,Counties Manukau,48,133,0,181
2020-08-22,Capital and Coast,0,93,2,95
2020-08-22,Canterbury,0,152,12,164
2020-08-22,Bay of Plenty,0,48,0,48
2020-08-22,Managed Isolation & Quarantine,16,54,0,70
2020-08-22,Total,111,1538,22,1671
2020-08-23,Auckland,31,176,0,207
2020-08-23,Whanganui,0,9,0,9
2020-08-23,West Coast,0,4,1,5
2020-08-23,Waitemata,16,233,4,253
2020-08-23,Wairarapa,0,8,0,8
2020-08-23,Waikato,1,186,1,188
2020-08-23,Taranaki,0,16,0,16
2020-08-23,Tairawhiti,0,4,0,4
2020-08-23,Southern,0,214,2,216
2020-08-23,South Canterbury,0,17,0,17
2020-08-23,Northland,0,28,0,28
2020-08-23,Nelson Marlborough,0,49,0,49
2020-08-23,Mid Central,0,32,0,32
2020-08-23,Lakes,0,16,0,16
2020-08-23,Hutt Valley,0,22,0,22
2020-08-23,Hawke's Bay,0,44,0,44
2020-08-23,Counties Manukau,48,133,0,181
2020-08-23,Capital and Coast,0,93,2,95
2020-08-23,Canterbury,0,152,12,164
2020-08-23,Bay of Plenty,0,48,0,48
2020-08-23,Managed Isolation & Quarantine,18,54,0,72
2020-08-23,Total,114,1538,22,1674
2020-08-24,Auckland,32,176,0,208
2020-08-24,Whanganui,0,9,0,9
2020-08-24,West Coast,0,4,1,5
2020-08-24,Waitemata,17,233,4,254
2020-08-24,Wairarapa,0,8,0,8
2020-08-24,Waikato,1,186,1,188
2020-08-24,Taranaki,0,16,0,16
2020-08-24,Tairawhiti,0,4,0,4
2020-08-24,Southern,0,214,2,216
2020-08-24,South Canterbury,0,17,0,17
2020-08-24,Northland,0,28,0,28
2020-08-24,Nelson Marlborough,0,49,0,49
2020-08-24,Mid Central,0,32,0,32
2020-08-24,Lakes,0,16,0,16
2020-08-24,Hutt Valley,0,22,0,22
2020-08-24,Hawke's Bay,0,44,0,44
2020-08-24,Counties Manukau,54,133,0,187
2020-08-24,Capital and Coast,0,93,2,95
2020-08-24,Canterbury,0,152,12,164
2020-08-24,Bay of Plenty,0,48,0,48
2020-08-24,Managed Isolation & Quarantine,19,54,0,73
2020-08-24,Total,123,1538,22,1683
2020-08-25,Auckland,35,176,0,211
2020-08-25,Whanganui,0,9,0,9
2020-08-25,West Coast,0,4,1,5
2020-08-25,Waitemata,17,234,4,255
2020-08-25,Wairarapa,0,8,0,8
2020-08-25,Waikato,1,186,1,188
2020-08-25,Taranaki,0,16,0,16
2020-08-25,Tairawhiti,0,4,0,4
2020-08-25,Southern,0,214,2,216
2020-08-25,South Canterbury,0,17,0,17
2020-08-25,Northland,0,28,0,28
2020-08-25,Nelson Marlborough,0,49,0,49
2020-08-25,Mid Central,0,32,0,32
2020-08-25,Lakes,0,16,0,16
2020-08-25,Hutt Valley,0,22,0,22
2020-08-25,Hawke's Bay,0,44,0,44
2020-08-25,Counties Manukau,57,133,0,190
2020-08-25,Capital and Coast,0,93,2,95
2020-08-25,Canterbury,0,152,12,164
2020-08-25,Bay of Plenty,0,48,0,48
2020-08-25,Managed Isolation & Quarantine,19,54,0,73
2020-08-25,Total,129,1539,22,1690
2020-08-26,Auckland,35,176,0,211
2020-08-26,Whanganui,0,9,0,9
2020-08-26,West Coast,0,4,1,5
2020-08-26,Waitemata,20,234,4,258
2020-08-26,Wairarapa,0,8,0,8
2020-08-26,Waikato,1,186,1,188
2020-08-26,Taranaki,0,16,0,16
2020-08-26,Tairawhiti,0,4,0,4
2020-08-26,Southern,0,214,2,216
2020-08-26,South Canterbury,0,17,0,17
2020-08-26,Northland,0,28,0,28
2020-08-26,Nelson Marlborough,0,49,0,49
2020-08-26,Mid Central,0,32,0,32
2020-08-26,Lakes,0,16,0,16
2020-08-26,Hutt Valley,0,22,0,22
2020-08-26,Hawke's Bay,0,44,0,44
2020-08-26,Counties Manukau,57,133,0,190
2020-08-26,Capital and Coast,0,93,2,95
2020-08-26,Canterbury,0,152,12,164
2020-08-26,Bay of Plenty,0,48,0,48
2020-08-26,Managed Isolation & Quarantine,21,54,0,75
2020-08-26,Total,134,1539,22,1695
2020-08-27,Auckland,35,177,0,212
2020-08-27,Whanganui,0,9,0,9
2020-08-27,West Coast,0,4,1,5
2020-08-27,Waitemata,22,236,4,262
2020-08-27,Wairarapa,0,8,0,8
2020-08-27,Waikato,1,186,1,188
2020-08-27,Taranaki,0,16,0,16
2020-08-27,Tairawhiti,0,4,0,4
2020-08-27,Southern,0,214,2,216
2020-08-27,South Canterbury,0,17,0,17
2020-08-27,Northland,0,28,0,28
2020-08-27,Nelson Marlborough,0,49,0,49
2020-08-27,Mid Central,0,32,0,32
2020-08-27,Lakes,0,16,0,16
2020-08-27,Hutt Valley,0,22,0,22
2020-08-27,Hawke's Bay,0,44,0,44
2020-08-27,Counties Manukau,57,134,0,191
2020-08-27,Capital and Coast,0,93,2,95
2020-08-27,Canterbury,0,152,12,164
2020-08-27,Bay of Plenty,0,48,0,48
2020-08-27,Managed Isolation & Quarantine,11,65,0,76
2020-08-27,Total,126,1554,22,1702
2020-08-28,Auckland,34,178,0,212
2020-08-28,Whanganui,0,9,0,9
2020-08-28,West Coast,0,4,1,5
2020-08-28,Waitemata,25,238,4,267
2020-08-28,Wairarapa,0,8,0,8
2020-08-28,Waikato,1,186,1,188
2020-08-28,Taranaki,0,16,0,16
2020-08-28,Tairawhiti,0,4,0,4
2020-08-28,Southern,0,214,2,216
2020-08-28,South Canterbury,0,17,0,17
2020-08-28,Northland,0,28,0,28
2020-08-28,Nelson Marlborough,0,49,0,49
2020-08-28,Mid Central,0,32,0,32
2020-08-28,Lakes,0,16,0,16
2020-08-28,Hutt Valley,0,22,0,22
2020-08-28,Hawke's Bay,0,44,0,44
2020-08-28,Counties Manukau,53,138,0,191
2020-08-28,Capital and Coast,0,93,2,95
2020-08-28,Canterbury,0,152,12,164
2020-08-28,Bay of Plenty,0,48,0,48
2020-08-28,Managed Isolation & Quarantine,18,65,0,83
2020-08-28,Total,131,1561,22,1714
2020-08-29,Auckland,35,179,0,214
2020-08-29,Whanganui,0,9,0,9
2020-08-29,West Coast,0,4,1,5
2020-08-29,Waitemata,28,238,4,270
2020-08-29,Wairarapa,0,8,0,8
2020-08-29,Waikato,1,186,1,188
2020-08-29,Taranaki,0,16,0,16
2020-08-29,Tairawhiti,0,4,0,4
2020-08-29,Southern,0,214,2,216
2020-08-29,South Canterbury,0,17,0,17
2020-08-29,Northland,0,28,0,28
2020-08-29,Nelson Marlborough,0,49,0,49
2020-08-29,Mid Central,0,32,0,32
2020-08-29,Lakes,0,16,0,16
2020-08-29,Hutt Valley,0,22,0,22
2020-08-29,Hawke's Bay,0,44,0,44
2020-08-29,Counties Manukau,53,144,0,197
2020-08-29,Capital and Coast,0,93,2,95
2020-08-29,Canterbury,0,152,12,164
2020-08-29,Bay of Plenty,0,48,0,48
2020-08-29,Managed Isolation & Quarantine,20,65,0,85
2020-08-29,Total,137,1568,22,1727
2020-08-30,Auckland,35,179,0,214
2020-08-30,Whanganui,0,9,0,9
2020-08-30,West Coast,0,4,1,5
2020-08-30,Waitemata,29,238,4,271
2020-08-30,Wairarapa,0,8,0,8
2020-08-30,Waikato,2,186,1,189
2020-08-30,Taranaki,0,16,0,16
2020-08-30,Tairawhiti,0,4,0,4
2020-08-30,Southern,0,214,2,216
2020-08-30,South Canterbury,0,17,0,17
2020-08-30,Northland,0,28,0,28
2020-08-30,Nelson Marlborough,0,49,0,49
2020-08-30,Mid Central,0,32,0,32
2020-08-30,Lakes,0,16,0,16
2020-08-30,Hutt Valley,0,22,0,22
2020-08-30,Hawke's Bay,0,44,0,44
2020-08-30,Counties Manukau,51,146,0,197
2020-08-30,Capital and Coast,0,93,2,95
2020-08-30,Canterbury,0,152,12,164
2020-08-30,Bay of Plenty,0,48,0,48
2020-08-30,Managed Isolation & Quarantine,20,65,0,85
2020-08-30,Total,137,1570,22,1729
2020-08-31,Auckland,30,187,0,217
2020-08-31,Whanganui,0,9,0,9
2020-08-31,West Coast,0,4,1,5
2020-08-31,Waitemata,29,239,4,272
2020-08-31,Wairarapa,0,8,0,8
2020-08-31,Waikato,2,186,1,189
2020-08-31,Taranaki,0,16,0,16
2020-08-31,Tairawhiti,0,4,0,4
2020-08-31,Southern,0,214,2,216
2020-08-31,South Canterbury,0,17,0,17
2020-08-31,Northland,0,28,0,28
2020-08-31,Nelson Marlborough,0,49,0,49
2020-08-31,Mid Central,0,32,0,32
2020-08-31,Lakes,0,16,0,16
2020-08-31,Hutt Valley,0,22,0,22
2020-08-31,Hawke's Bay,0,44,0,44
2020-08-31,Counties Manukau,46,152,0,198
2020-08-31,Capital and Coast,0,93,2,95
2020-08-31,Canterbury,0,152,12,164
2020-08-31,Bay of Plenty,0,48,0,48
2020-08-31,Managed Isolation & Quarantine,24,65,0,89
2020-08-31,Total,131,1585,22,1738
2020-09-01,Auckland,25,192,0,217
2020-09-01,Whanganui,0,9,0,9
2020-09-01,West Coast,0,4,1,5
2020-09-01,Waitemata,26,242,4,272
2020-09-01,Wairarapa,0,8,0,8
2020-09-01,Waikato,2,186,1,189
2020-09-01,Taranaki,0,16,0,16
2020-09-01,Tairawhiti,0,4,0,4
2020-09-01,Southern,0,214,2,216
2020-09-01,South Canterbury,0,17,0,17
2020-09-01,Northland,0,28,0,28
2020-09-01,Nelson Marlborough,0,49,0,49
2020-09-01,Mid Central,0,32,0,32
2020-09-01,Lakes,0,16,0,16
2020-09-01,Hutt Valley,0,22,0,22
2020-09-01,Hawke's Bay,0,44,0,44
2020-09-01,Counties Manukau,46,157,0,203
2020-09-01,Capital and Coast,0,93,2,95
2020-09-01,Canterbury,0,152,12,164
2020-09-01,Bay of Plenty,0,48,0,48
2020-09-01,Managed Isolation & Quarantine,33,65,0,98
2020-09-01,Total,132,1598,22,1752
2020-09-02,Auckland,26,193,0,219
2020-09-02,Whanganui,0,9,0,9
2020-09-02,West Coast,0,4,1,5
2020-09-02,Waitemata,27,242,4,273
2020-09-02,Wairarapa,0,8,0,8
2020-09-02,Waikato,2,186,1,189
2020-09-02,Taranaki,0,16,0,16
2020-09-02,Tairawhiti,0,4,0,4
2020-09-02,Southern,0,214,2,216
2020-09-02,South Canterbury,0,17,0,17
2020-09-02,Northland,0,28,0,28
2020-09-02,Nelson Marlborough,0,49,0,49
2020-09-02,Mid Central,0,32,0,32
2020-09-02,Lakes,0,16,0,16
2020-09-02,Hutt Valley,0,22,0,22
2020-09-02,Hawke's Bay,0,44,0,44
2020-09-02,Counties Manukau,39,164,0,203
2020-09-02,Capital and Coast,0,93,2,95
2020-09-02,Canterbury,0,152,12,164
2020-09-02,Bay of Plenty,0,48,0,48
2020-09-02,Managed Isolation & Quarantine,35,65,0,100
2020-09-02,Total,129,1606,22,1757
2020-09-03,Auckland,24,195,0,219
2020-09-03,Whanganui,0,9,0,9
2020-09-03,West Coast,0,4,1,5
2020-09-03,Waitemata,22,247,4,273
2020-09-03,Wairarapa,0,8,0,8
2020-09-03,Waikato,2,186,1,189
2020-09-03,Taranaki,0,16,0,16
2020-09-03,Tairawhiti,0,4,0,4
2020-09-03,Southern,0,214,2,216
2020-09-03,South Canterbury,0,17,0,17
2020-09-03,Northland,0,28,0,28
2020-09-03,Nelson Marlborough,0,49,0,49
2020-09-03,Mid Central,0,32,0,32
2020-09-03,Lakes,0,16,0,16
2020-09-03,Hutt Valley,0,22,0,22
2020-09-03,Hawke's Bay,0,44,0,44
2020-09-03,Counties Manukau,31,173,0,204
2020-09-03,Capital and Coast,0,93,2,95
2020-09-03,Canterbury,0,152,12,164
2020-09-03,Bay of Plenty,0,48,0,48
2020-09-03,Managed Isolation & Quarantine,36,65,0,101
2020-09-03,Total,115,1622,22,1759
2020-09-04,Auckland,24,195,0,219
2020-09-04,Whanganui,0,9,0,9
2020-09-04,West Coast,0,4,1,5
2020-09-04,Waitemata,21,249,4,274
2020-09-04,Wairarapa,0,8,0,8
2020-09-04,Waikato,2,186,1,189
2020-09-04,Taranaki,0,16,0,16
2020-09-04,Tairawhiti,0,4,0,4
2020-09-04,Southern,0,214,2,216
2020-09-04,South Canterbury,0,17,0,17
2020-09-04,Northland,0,28,0,28
2020-09-04,Nelson Marlborough,0,49,0,49
2020-09-04,Mid Central,0,32,0,32
2020-09-04,Lakes,0,16,0,16
2020-09-04,Hutt Valley,0,22,0,22
2020-09-04,Hawke's Bay,0,44,0,44
2020-09-04,Counties Manukau,28,178,0,206
2020-09-04,Capital and Coast,0,93,2,95
2020-09-04,Canterbury,0,152,12,164
2020-09-04,Bay of Plenty,0,48,0,48
2020-09-04,Managed Isolation & Quarantine,37,66,0,103
2020-09-04,Total,112,1630,22,1764
2020-09-05,Auckland,23,195,1,219
2020-09-05,Whanganui,0,9,0,9
2020-09-05,West Coast,0,4,1,5
2020-09-05,Waitemata,22,249,4,275
2020-09-05,Wairarapa,0,8,0,8
2020-09-05,Waikato,1,186,1,188
2020-09-05,Taranaki,0,16,0,16
2020-09-05,Tairawhiti,0,4,0,4
2020-09-05,Southern,0,214,2,216
2020-09-05,South Canterbury,0,17,0,17
2020-09-05,Northland,0,28,0,28
2020-09-05,Nelson Marlborough,0,49,0,49
2020-09-05,Mid Central,0,32,0,32
2020-09-05,Lakes,0,16,0,16
2020-09-05,Hutt Valley,0,22,0,22
2020-09-05,Hawke's Bay,0,44,0,44
2020-09-05,Counties Manukau,28,179,1,208
2020-09-05,Capital and Coast,0,93,2,95
2020-09-05,Canterbury,0,152,12,164
2020-09-05,Bay of Plenty,0,48,0,48
2020-09-05,Managed Isolation & Quarantine,38,66,0,104
2020-09-05,Total,112,1631,24,1767
2020-09-06,Auckland,23,195,1,219
2020-09-06,Whanganui,0,9,0,9
2020-09-06,West Coast,0,4,1,5
2020-09-06,Waitemata,26,249,4,279
2020-09-06,Wairarapa,0,8,0,8
2020-09-06,Waikato,1,186,1,188
2020-09-06,Taranaki,0,16,0,16
2020-09-06,Tairawhiti,0,4,0,4
2020-09-06,Southern,0,214,2,216
2020-09-06,South Canterbury,0,17,0,17
2020-09-06,Northland,0,28,0,28
2020-09-06,Nelson Marlborough,0,49,0,49
2020-09-06,Mid Central,0,32,0,32
2020-09-06,Lakes,0,16,0,16
2020-09-06,Hutt Valley,0,22,0,22
2020-09-06,Hawke's Bay,0,44,0,44
2020-09-06,Counties Manukau,27,180,1,208
2020-09-06,Capital and Coast,0,93,2,95
2020-09-06,Canterbury,0,152,12,164
2020-09-06,Bay of Plenty,0,48,0,48
2020-09-06,Managed Isolation & Quarantine,39,66,0,105
2020-09-06,Total,116,1632,24,1772
2020-09-07,Auckland,22,196,1,219
2020-09-07,Whanganui,0,9,0,9
2020-09-07,West Coast,0,4,1,5
2020-09-07,Waitemata,28,249,4,281
2020-09-07,Wairarapa,0,8,0,8
2020-09-07,Waikato,1,186,1,188
2020-09-07,Taranaki,0,16,0,16
2020-09-07,Tairawhiti,0,4,0,4
2020-09-07,Southern,0,214,2,216
2020-09-07,South Canterbury,0,17,0,17
2020-09-07,Northland,0,28,0,28
2020-09-07,Nelson Marlborough,0,49,0,49
2020-09-07,Mid Central,0,32,0,32
2020-09-07,Lakes,0,16,0,16
2020-09-07,Hutt Valley,0,22,0,22
2020-09-07,Hawke's Bay,0,44,0,44
2020-09-07,Counties Manukau,26,181,1,208
2020-09-07,Capital and Coast,0,93,2,95
2020-09-07,Canterbury,0,152,12,164
2020-09-07,Bay of Plenty,0,48,0,48
2020-09-07,Managed Isolation & Quarantine,41,66,0,107
2020-09-07,Total,118,1634,24,1776
2020-09-08,Auckland,21,197,1,219
2020-09-08,Whanganui,0,9,0,9
2020-09-08,West Coast,0,4,1,5
2020-09-08,Waitemata,32,249,4,285
2020-09-08,Wairarapa,0,8,0,8
2020-09-08,Waikato,1,186,1,188
2020-09-08,Taranaki,0,16,0,16
2020-09-08,Tairawhiti,0,4,0,4
2020-09-08,Southern,0,214,2,216
2020-09-08,South Canterbury,0,17,0,17
2020-09-08,Northland,0,28,0,28
2020-09-08,Nelson Marlborough,0,49,0,49
2020-09-08,Mid Central,0,32,0,32
2020-09-08,Lakes,0,16,0,16
2020-09-08,Hutt Valley,0,22,0,22
2020-09-08,Hawke's Bay,0,44,0,44
2020-09-08,Counties Manukau,26,181,1,208
2020-09-08,Capital and Coast,0,93,2,95
2020-09-08,Canterbury,0,152,12,164
2020-09-08,Bay of Plenty,0,48,0,48
2020-09-08,Managed Isolation & Quarantine,43,66,0,109
2020-09-08,Total,123,1635,24,1782
2020-09-09,Auckland,21,199,1,221
2020-09-09,Whanganui,0,9,0,9
2020-09-09,West Coast,0,4,1,5
2020-09-09,Waitemata,35,249,4,288
2020-09-09,Wairarapa,0,8,0,8
2020-09-09,Waikato,1,186,1,188
2020-09-09,Taranaki,0,16,0,16
2020-09-09,Tairawhiti,0,4,0,4
2020-09-09,Southern,0,214,2,216
2020-09-09,South Canterbury,0,17,0,17
2020-09-09,Northland,0,28,0,28
2020-09-09,Nelson Marlborough,0,49,0,49
2020-09-09,Mid Central,0,32,0,32
2020-09-09,Lakes,0,16,0,16
2020-09-09,Hutt Valley,0,22,0,22
2020-09-09,Hawke's Bay,0,44,0,44
2020-09-09,Counties Manukau,25,183,1,209
2020-09-09,Capital and Coast,0,93,2,95
2020-09-09,Canterbury,0,152,12,164
2020-09-09,Bay of Plenty,0,48,0,48
2020-09-09,Managed Isolation & Quarantine,43,66,0,109
2020-09-09,Total,125,1639,24,1788
2020-09-10,Auckland,20,200,1,221
2020-09-10,Whanganui,0,9,0,9
2020-09-10,West Coast,0,4,1,5
2020-09-10,Waitemata,36,249,4,289
2020-09-10,Wairarapa,0,8,0,8
2020-09-10,Waikato,1,186,1,188
2020-09-10,Taranaki,0,16,0,16
2020-09-10,Tairawhiti,0,4,0,4
2020-09-10,Southern,0,214,2,216
2020-09-10,South Canterbury,0,17,0,17
2020-09-10,Northland,0,28,0,28
2020-09-10,Nelson Marlborough,0,49,0,49
2020-09-10,Mid Central,0,32,0,32
2020-09-10,Lakes,0,16,0,16
2020-09-10,Hutt Valley,0,22,0,22
2020-09-10,Hawke's Bay,0,44,0,44
2020-09-10,Counties Manukau,24,185,1,210
2020-09-10,Capital and Coast,0,93,2,95
2020-09-10,Canterbury,0,152,12,164
2020-09-10,Bay of Plenty,0,48,0,48
2020-09-10,Managed Isolation & Quarantine,39,72,0,111
2020-09-10,Total,120,1648,24,1792
2020-09-11,Auckland,19,202,1,222
2020-09-11,Whanganui,0,9,0,9
2020-09-11,West Coast,0,4,1,5
2020-09-11,Waitemata,34,251,4,289
2020-09-11,Wairarapa,0,8,0,8
2020-09-11,Waikato,1,186,1,188
2020-09-11,Taranaki,0,16,0,16
2020-09-11,Tairawhiti,0,4,0,4
2020-09-11,Southern,0,214,2,216
2020-09-11,South Canterbury,0,17,0,17
2020-09-11,Northland,0,28,0,28
2020-09-11,Nelson Marlborough,0,49,0,49
2020-09-11,Mid Central,0,32,0,32
2020-09-11,Lakes,0,16,0,16
2020-09-11,Hutt Valley,0,22,0,22
2020-09-11,Hawke's Bay,0,44,0,44
2020-09-11,Counties Manukau,21,188,1,210
2020-09-11,Capital and Coast,0,93,2,95
2020-09-11,Canterbury,0,152,12,164
2020-09-11,Bay of Plenty,0,48,0,48
2020-09-11,Managed Isolation & Quarantine,39,72,0,111
2020-09-11,Total,114,1655,24,1793
2020-09-12,Auckland,18,203,1,222
2020-09-12,Whanganui,0,9,0,9
2020-09-12,West Coast,0,4,1,5
2020-09-12,Waitemata,33,254,4,291
2020-09-12,Wairarapa,0,8,0,8
2020-09-12,Waikato,1,186,1,188
2020-09-12,Taranaki,0,16,0,16
2020-09-12,Tairawhiti,0,4,0,4
2020-09-12,Southern,0,214,2,216
2020-09-12,South Canterbury,0,17,0,17
2020-09-12,Northland,0,28,0,28
2020-09-12,Nelson Marlborough,0,49,0,49
2020-09-12,Mid Central,0,32,0,32
2020-09-12,Lakes,0,16,0,16
2020-09-12,Hutt Valley,0,22,0,22
2020-09-12,Hawke's Bay,0,44,0,44
2020-09-12,Counties Manukau,18,191,1,210
2020-09-12,Capital and Coast,0,93,2,95
2020-09-12,Canterbury,0,152,12,164
2020-09-12,Bay of Plenty,0,48,0,48
2020-09-12,Managed Isolation & Quarantine,38,73,0,111
2020-09-12,Total,108,1663,24,1795
2020-09-13,Auckland,16,205,1,222
2020-09-13,Whanganui,0,9,0,9
2020-09-13,West Coast,0,4,1,5
2020-09-13,Waitemata,28,260,4,292
2020-09-13,Wairarapa,0,8,0,8
2020-09-13,Waikato,1,186,1,188
2020-09-13,Taranaki,0,16,0,16
2020-09-13,Tairawhiti,0,4,0,4
2020-09-13,Southern,0,214,2,216
2020-09-13,South Canterbury,0,17,0,17
2020-09-13,Northland,0,28,0,28
2020-09-13,Nelson Marlborough,0,49,0,49
2020-09-13,Mid Central,0,32,0,32
2020-09-13,Lakes,0,16,0,16
2020-09-13,Hutt Valley,0,22,0,22
2020-09-13,Hawke's Bay,0,44,0,44
2020-09-13,Counties Manukau,13,196,1,210
2020-09-13,Capital and Coast,0,93,2,95
2020-09-13,Canterbury,0,152,12,164
2020-09-13,Bay of Plenty,0,48,0,48
2020-09-13,Managed Isolation & Quarantine,39,73,0,112
2020-09-13,Total,97,1676,24,1797
2020-09-14,Auckland,16,205,1,222
2020-09-14,Whanganui,0,9,0,9
2020-09-14,West Coast,0,4,1,5
2020-09-14,Waitemata,27,261,4,292
2020-09-14,Wairarapa,0,8,0,8
2020-09-14,Waikato,1,186,1,188
2020-09-14,Taranaki,0,16,0,16
2020-09-14,Tairawhiti,0,4,0,4
2020-09-14,Southern,0,214,2,216
2020-09-14,South Canterbury,0,17,0,17
2020-09-14,Northland,0,28,0,28
2020-09-14,Nelson Marlborough,0,49,0,49
2020-09-14,Mid Central,0,32,0,32
2020-09-14,Lakes,0,16,0,16
2020-09-14,Hutt Valley,0,22,0,22
2020-09-14,Hawke's Bay,0,44,0,44
2020-09-14,Counties Manukau,13,197,1,211
2020-09-14,Capital and Coast,0,93,2,95
2020-09-14,Canterbury,0,152,12,164
2020-09-14,Bay of Plenty,0,48,0,48
2020-09-14,Managed Isolation & Quarantine,39,73,0,112
2020-09-14,Total,96,1678,24,1798
2020-09-15,Auckland,15,206,1,222
2020-09-15,Whanganui,0,9,0,9
2020-09-15,West Coast,0,4,1,5
2020-09-15,Waitemata,26,262,4,292
2020-09-15,Wairarapa,0,8,0,8
2020-09-15,Waikato,1,186,1,188
2020-09-15,Taranaki,0,16,0,16
2020-09-15,Tairawhiti,0,4,0,4
2020-09-15,Southern,0,214,2,216
2020-09-15,South Canterbury,0,17,0,17
2020-09-15,Northland,0,28,0,28
2020-09-15,Nelson Marlborough,0,49,0,49
2020-09-15,Mid Central,0,32,0,32
2020-09-15,Lakes,0,16,0,16
2020-09-15,Hutt Valley,0,22,0,22
2020-09-15,Hawke's Bay,0,44,0,44
2020-09-15,Counties Manukau,13,197,1,211
2020-09-15,Capital and Coast,0,93,2,95
2020-09-15,Canterbury,0,152,12,164
2020-09-15,Bay of Plenty,0,48,0,48
2020-09-15,Managed Isolation & Quarantine,28,87,0,115
2020-09-15,Total,83,1694,24,1801
2020-09-16,Auckland,13,208,1,222
2020-09-16,Whanganui,0,9,0,9
2020-09-16,West Coast,0,4,1,5
2020-09-16,Waitemata,26,262,4,292
2020-09-16,Wairarapa,0,8,0,8
2020-09-16,Waikato,0,186,2,188
2020-09-16,Taranaki,0,16,0,16
2020-09-16,Tairawhiti,0,4,0,4
2020-09-16,Southern,0,214,2,216
2020-09-16,South Canterbury,0,17,0,17
2020-09-16,Northland,0,28,0,28
2020-09-16,Nelson Marlborough,0,49,0,49
2020-09-16,Mid Central,0,32,0,32
2020-09-16,Lakes,0,16,0,16
2020-09-16,Hutt Valley,0,22,0,22
2020-09-16,Hawke's Bay,0,44,0,44
2020-09-16,Counties Manukau,13,197,1,211
2020-09-16,Capital and Coast,0,93,2,95
2020-09-16,Canterbury,0,152,12,164
2020-09-16,Bay of Plenty,0,48,0,48
2020-09-16,Managed Isolation & Quarantine,27,89,0,116
2020-09-16,Total,79,1698,25,1802
2020-09-17,Auckland,11,210,1,222
2020-09-17,Whanganui,0,9,0,9
2020-09-17,West Coast,0,4,1,5
2020-09-17,Waitemata,22,266,4,292
2020-09-17,Wairarapa,0,8,0,8
2020-09-17,Waikato,0,186,2,188
2020-09-17,Taranaki,0,16,0,16
2020-09-17,Tairawhiti,0,4,0,4
2020-09-17,Southern,0,214,2,216
2020-09-17,South Canterbury,0,17,0,17
2020-09-17,Northland,0,28,0,28
2020-09-17,Nelson Marlborough,0,49,0,49
2020-09-17,Mid Central,0,32,0,32
2020-09-17,Lakes,0,16,0,16
2020-09-17,Hutt Valley,0,22,0,22
2020-09-17,Hawke's Bay,0,44,0,44
2020-09-17,Counties Manukau,11,199,1,211
2020-09-17,Capital and Coast,0,93,2,95
2020-09-17,Canterbury,0,152,12,164
2020-09-17,Bay of Plenty,0,48,0,48
2020-09-17,Managed Isolation & Quarantine,33,90,0,123
2020-09-17,Total,77,1707,25,1809
2020-09-18,Auckland,9,212,1,222
2020-09-18,Whanganui,0,9,0,9
2020-09-18,West Coast,0,4,1,5
2020-09-18,Waitemata,17,271,4,292
2020-09-18,Wairarapa,0,8,0,8
2020-09-18,Waikato,0,186,2,188
2020-09-18,Taranaki,0,16,0,16
2020-09-18,Tairawhiti,0,4,0,4
2020-09-18,Southern,0,214,2,216
2020-09-18,South Canterbury,0,17,0,17
2020-09-18,Northland,0,28,0,28
2020-09-18,Nelson Marlborough,0,49,0,49
2020-09-18,Mid Central,0,32,0,32
2020-09-18,Lakes,0,16,0,16
2020-09-18,Hutt Valley,0,22,0,22
2020-09-18,Hawke's Bay,0,44,0,44
2020-09-18,Counties Manukau,11,199,1,211
2020-09-18,Capital and Coast,0,93,2,95
2020-09-18,Canterbury,0,152,12,164
2020-09-18,Bay of Plenty,0,48,0,48
2020-09-18,Managed Isolation & Quarantine,33,90,0,123
2020-09-18,Total,70,1714,25,1809
2020-09-19,Auckland,8,213,1,222
2020-09-19,Whanganui,0,9,0,9
2020-09-19,West Coast,0,4,1,5
2020-09-19,Waitemata,15,273,4,292
2020-09-19,Wairarapa,0,8,0,8
2020-09-19,Waikato,0,186,2,188
2020-09-19,Taranaki,0,16,0,16
2020-09-19,Tairawhiti,0,4,0,4
2020-09-19,Southern,0,214,2,216
2020-09-19,South Canterbury,0,17,0,17
2020-09-19,Northland,0,28,0,28
2020-09-19,Nelson Marlborough,0,49,0,49
2020-09-19,Mid Central,0,32,0,32
2020-09-19,Lakes,0,16,0,16
2020-09-19,Hutt Valley,0,22,0,22
2020-09-19,Hawke's Bay,0,44,0,44
2020-09-19,Counties Manukau,10,200,1,211
2020-09-19,Capital and Coast,0,93,2,95
2020-09-19,Canterbury,0,152,12,164
2020-09-19,Bay of Plenty,0,48,0,48
2020-09-19,Managed Isolation & Quarantine,34,91,0,125
2020-09-19,Total,67,1719,25,1811
2020-09-20,Auckland,9,213,1,223
2020-09-20,Whanganui,0,9,0,9
2020-09-20,West Coast,0,4,1,5
2020-09-20,Waitemata,15,273,4,292
2020-09-20,Wairarapa,0,8,0,8
2020-09-20,Waikato,0,186,2,188
2020-09-20,Taranaki,0,16,0,16
2020-09-20,Tairawhiti,0,4,0,4
2020-09-20,Southern,0,214,2,216
2020-09-20,South Canterbury,0,17,0,17
2020-09-20,Northland,0,28,0,28
2020-09-20,Nelson Marlborough,0,49,0,49
2020-09-20,Mid Central,0,32,0,32
2020-09-20,Lakes,0,16,0,16
2020-09-20,Hutt Valley,0,22,0,22
2020-09-20,Hawke's Bay,0,44,0,44
2020-09-20,Counties Manukau,12,200,1,213
2020-09-20,Capital and Coast,0,93,2,95
2020-09-20,Canterbury,0,152,12,164
2020-09-20,Bay of Plenty,0,48,0,48
2020-09-20,Managed Isolation & Quarantine,35,91,0,126
2020-09-20,Total,71,1719,25,1815
2020-09-21,Auckland,9,213,1,223
2020-09-21,Whanganui,0,9,0,9
2020-09-21,West Coast,0,4,1,5
2020-09-21,Waitemata,12,276,4,292
2020-09-21,Wairarapa,0,8,0,8
2020-09-21,Waikato,0,186,2,188
2020-09-21,Taranaki,0,16,0,16
2020-09-21,Tairawhiti,0,4,0,4
2020-09-21,Southern,0,214,2,216
2020-09-21,South Canterbury,0,17,0,17
2020-09-21,Northland,0,28,0,28
2020-09-21,Nelson Marlborough,0,49,0,49
2020-09-21,Mid Central,0,32,0,32
2020-09-21,Lakes,0,16,0,16
2020-09-21,Hutt Valley,0,22,0,22
2020-09-21,Hawke's Bay,0,44,0,44
2020-09-21,Counties Manukau,12,200,1,213
2020-09-21,Capital and Coast,0,93,2,95
2020-09-21,Canterbury,0,152,12,164
2020-09-21,Bay of Plenty,0,48,0,48
2020-09-21,Managed Isolation & Quarantine,29,97,0,126
2020-09-21,Total,62,1728,25,1815
2020-09-22,Auckland,9,213,1,223
2020-09-22,Whanganui,0,9,0,9
2020-09-22,West Coast,0,4,1,5
2020-09-22,Waitemata,12,276,4,292
2020-09-22,Wairarapa,0,8,0,8
2020-09-22,Waikato,0,186,2,188
2020-09-22,Taranaki,0,16,0,16
2020-09-22,Tairawhiti,0,4,0,4
2020-09-22,Southern,0,214,2,216
2020-09-22,South Canterbury,0,17,0,17
2020-09-22,Northland,0,28,0,28
2020-09-22,Nelson Marlborough,0,49,0,49
2020-09-22,Mid Central,0,32,0,32
2020-09-22,Lakes,0,16,0,16
2020-09-22,Hutt Valley,0,22,0,22
2020-09-22,Hawke's Bay,0,44,0,44
2020-09-22,Counties Manukau,11,201,1,213
2020-09-22,Capital and Coast,0,93,2,95
2020-09-22,Canterbury,0,152,12,164
2020-09-22,Bay of Plenty,0,48,0,48
2020-09-22,Managed Isolation & Quarantine,29,97,0,126
2020-09-22,Total,61,1729,25,1815
2020-09-23,Auckland,12,213,1,226
2020-09-23,Whanganui,0,9,0,9
2020-09-23,West Coast,0,4,1,5
2020-09-23,Waitemata,11,277,4,292
2020-09-23,Wairarapa,0,8,0,8
2020-09-23,Waikato,0,192,2,194
2020-09-23,Taranaki,0,16,0,16
2020-09-23,Tairawhiti,0,4,0,4
2020-09-23,Southern,0,214,2,216
2020-09-23,South Canterbury,0,17,0,17
2020-09-23,Northland,0,28,0,28
2020-09-23,Nelson Marlborough,0,49,0,49
2020-09-23,Mid Central,0,32,0,32
2020-09-23,Lakes,0,16,0,16
2020-09-23,Hutt Valley,0,22,0,22
2020-09-23,Hawke's Bay,0,44,0,44
2020-09-23,Counties Manukau,11,201,1,213
2020-09-23,Capital and Coast,0,93,2,95
2020-09-23,Canterbury,0,152,12,164
2020-09-23,Bay of Plenty,0,48,0,48
2020-09-23,Managed Isolation & Quarantine,28,98,0,126
2020-09-23,Total,62,1737,25,1824
2020-09-24,Auckland,12,213,1,226
2020-09-24,Whanganui,0,9,0,9
2020-09-24,West Coast,0,4,1,5
2020-09-24,Waitemata,11,277,4,292
2020-09-24,Wairarapa,0,8,0,8
2020-09-24,Waikato,0,192,2,194
2020-09-24,Taranaki,0,16,0,16
2020-09-24,Tairawhiti,0,4,0,4
2020-09-24,Southern,0,214,2,216
2020-09-24,South Canterbury,0,17,0,17
2020-09-24,Northland,0,28,0,28
2020-09-24,Nelson Marlborough,0,49,0,49
2020-09-24,Mid Central,0,32,0,32
2020-09-24,Lakes,0,16,0,16
2020-09-24,Hutt Valley,0,22,0,22
2020-09-24,Hawke's Bay,0,44,0,44
2020-09-24,Counties Manukau,11,201,1,213
2020-09-24,Capital and Coast,0,93,2,95
2020-09-24,Canterbury,0,152,12,164
2020-09-24,Bay of Plenty,0,48,0,48
2020-09-24,Managed Isolation & Quarantine,31,98,0,129
2020-09-24,Total,65,1737,25,1827
2020-09-25,Auckland,12,213,1,226
2020-09-25,Whanganui,0,9,0,9
2020-09-25,West Coast,0,4,1,5
2020-09-25,Waitemata,10,279,4,293
2020-09-25,Wairarapa,0,8,0,8
2020-09-25,Waikato,0,192,2,194
2020-09-25,Taranaki,0,16,0,16
2020-09-25,Tairawhiti,0,4,0,4
2020-09-25,Southern,0,214,2,216
2020-09-25,South Canterbury,0,17,0,17
2020-09-25,Northland,0,28,0,28
2020-09-25,Nelson Marlborough,0,49,0,49
2020-09-25,Mid Central,0,32,0,32
2020-09-25,Lakes,0,16,0,16
2020-09-25,Hutt Valley,0,22,0,22
2020-09-25,Hawke's Bay,0,44,0,44
2020-09-25,Counties Manukau,9,203,1,213
2020-09-25,Capital and Coast,0,93,2,95
2020-09-25,Canterbury,0,152,12,164
2020-09-25,Bay of Plenty,0,48,0,48
2020-09-25,Managed Isolation & Quarantine,29,101,0,130
2020-09-25,Total,60,1744,25,1829
2020-09-26,Auckland,12,213,1,226
2020-09-26,Whanganui,0,9,0,9
2020-09-26,West Coast,0,4,1,5
2020-09-26,Waitemata,10,279,4,293
2020-09-26,Wairarapa,0,8,0,8
2020-09-26,Waikato,0,192,2,194
2020-09-26,Taranaki,0,16,0,16
2020-09-26,Tairawhiti,0,4,0,4
2020-09-26,Southern,0,214,2,216
2020-09-26,South Canterbury,0,17,0,17
2020-09-26,Northland,0,28,0,28
2020-09-26,Nelson Marlborough,0,49,0,49
2020-09-26,Mid Central,0,32,0,32
2020-09-26,Lakes,0,16,0,16
2020-09-26,Hutt Valley,0,22,0,22
2020-09-26,Hawke's Bay,0,44,0,44
2020-09-26,Counties Manukau,9,204,1,214
2020-09-26,Capital and Coast,0,93,2,95
2020-09-26,Canterbury,0,152,12,164
2020-09-26,Bay of Plenty,0,48,0,48
2020-09-26,Managed Isolation & Quarantine,30,101,0,131
2020-09-26,Total,61,1745,25,1831
2020-09-27,Auckland,12,213,1,226
2020-09-27,Whanganui,0,9,0,9
2020-09-27,West Coast,0,4,1,5
2020-09-27,Waitemata,10,279,4,293
2020-09-27,Wairarapa,0,8,0,8
2020-09-27,Waikato,0,192,2,194
2020-09-27,Taranaki,0,16,0,16
2020-09-27,Tairawhiti,0,4,0,4
2020-09-27,Southern,0,214,2,216
2020-09-27,South Canterbury,0,17,0,17
2020-09-27,Northland,0,28,0,28
2020-09-27,Nelson Marlborough,0,49,0,49
2020-09-27,Mid Central,0,32,0,32
2020-09-27,Lakes,0,16,0,16
2020-09-27,Hutt Valley,0,22,0,22
2020-09-27,Hawke's Bay,0,44,0,44
2020-09-27,Counties Manukau,9,204,1,214
2020-09-27,Capital and Coast,0,93,2,95
2020-09-27,Canterbury,0,152,12,164
2020-09-27,Bay of Plenty,0,48,0,48
2020-09-27,Managed Isolation & Quarantine,28,105,0,133
2020-09-27,Total,59,1749,25,1833
2020-09-28,Auckland,11,214,1,226
2020-09-28,Whanganui,0,9,0,9
2020-09-28,West Coast,0,4,1,5
2020-09-28,Waitemata,8,281,4,293
2020-09-28,Wairarapa,0,8,0,8
2020-09-28,Waikato,0,192,2,194
2020-09-28,Taranaki,0,16,0,16
2020-09-28,Tairawhiti,0,4,0,4
2020-09-28,Southern,0,214,2,216
2020-09-28,South Canterbury,0,17,0,17
2020-09-28,Northland,0,28,0,28
2020-09-28,Nelson Marlborough,0,49,0,49
2020-09-28,Mid Central,0,32,0,32
2020-09-28,Lakes,0,16,0,16
2020-09-28,Hutt Valley,0,22,0,22
2020-09-28,Hawke's Bay,0,44,0,44
2020-09-28,Counties Manukau,8,205,1,214
2020-09-28,Capital and Coast,0,93,2,95
2020-09-28,Canterbury,0,152,12,164
2020-09-28,Bay of Plenty,0,48,0,48
2020-09-28,Managed Isolation & Quarantine,28,105,0,133
2020-09-28,Total,55,1753,25,1833
2020-09-29,Auckland,10,215,1,226
2020-09-29,Whanganui,0,9,0,9
2020-09-29,West Coast,0,4,1,5
2020-09-29,Waitemata,8,281,4,293
2020-09-29,Wairarapa,0,8,0,8
2020-09-29,Waikato,0,192,2,194
2020-09-29,Taranaki,0,16,0,16
2020-09-29,Tairawhiti,0,4,0,4
2020-09-29,Southern,0,214,2,216
2020-09-29,South Canterbury,0,17,0,17
2020-09-29,Northland,0,28,0,28
2020-09-29,Nelson Marlborough,0,49,0,49
2020-09-29,Mid Central,0,32,0,32
2020-09-29,Lakes,0,16,0,16
2020-09-29,Hutt Valley,0,22,0,22
2020-09-29,Hawke's Bay,0,44,0,44
2020-09-29,Counties Manukau,8,205,1,214
2020-09-29,Capital and Coast,0,93,2,95
2020-09-29,Canterbury,0,152,12,164
2020-09-29,Bay of Plenty,0,48,0,48
2020-09-29,Managed Isolation & Quarantine,29,106,0,135
2020-09-29,Total,55,1755,25,1835
2020-09-30,Auckland,5,220,1,226
2020-09-30,Whanganui,0,9,0,9
2020-09-30,West Coast,0,4,1,5
2020-09-30,Waitemata,4,285,4,293
2020-09-30,Wairarapa,0,8,0,8
2020-09-30,Waikato,0,192,2,194
2020-09-30,Taranaki,0,16,0,16
2020-09-30,Tairawhiti,0,4,0,4
2020-09-30,Southern,0,214,2,216
2020-09-30,South Canterbury,0,17,0,17
2020-09-30,Northland,0,28,0,28
2020-09-30,Nelson Marlborough,0,49,0,49
2020-09-30,Mid Central,0,32,0,32
2020-09-30,Lakes,0,16,0,16
2020-09-30,Hutt Valley,0,22,0,22
2020-09-30,Hawke's Bay,0,44,0,44
2020-09-30,Counties Manukau,5,208,1,214
2020-09-30,Capital and Coast,0,93,2,95
2020-09-30,Canterbury,0,152,12,164
2020-09-30,Bay of Plenty,0,48,0,48
2020-09-30,Managed Isolation & Quarantine,30,106,0,136
2020-09-30,Total,44,1767,25,1836
2020-10-01,Auckland,4,221,1,226
2020-10-01,Whanganui,0,9,0,9
2020-10-01,West Coast,0,4,1,5
2020-10-01,Waitemata,3,286,4,293
2020-10-01,Wairarapa,0,8,0,8
2020-10-01,Waikato,0,192,2,194
2020-10-01,Taranaki,0,16,0,16
2020-10-01,Tairawhiti,0,4,0,4
2020-10-01,Southern,0,214,2,216
2020-10-01,South Canterbury,0,17,0,17
2020-10-01,Northland,0,28,0,28
2020-10-01,Nelson Marlborough,0,49,0,49
2020-10-01,Mid Central,0,32,0,32
2020-10-01,Lakes,0,16,0,16
2020-10-01,Hutt Valley,0,22,0,22
2020-10-01,Hawke's Bay,0,44,0,44
2020-10-01,Counties Manukau,4,209,1,214
2020-10-01,Capital and Coast,0,93,2,95
2020-10-01,Canterbury,0,152,12,164
2020-10-01,Bay of Plenty,0,48,0,48
2020-10-01,Managed Isolation & Quarantine,42,106,0,148
2020-10-01,Total,53,1776,25,1848
2020-10-02,Auckland,4,221,1,226
2020-10-02,Whanganui,0,9,0,9
2020-10-02,West Coast,0,4,1,5
2020-10-02,Waitemata,3,286,4,293
2020-10-02,Wairarapa,0,8,0,8
2020-10-02,Waikato,0,192,2,194
2020-10-02,Taranaki,0,16,0,16
2020-10-02,Tairawhiti,0,4,0,4
2020-10-02,Southern,0,214,2,216
2020-10-02,South Canterbury,0,17,0,17
2020-10-02,Northland,0,28,0,28
2020-10-02,Nelson Marlborough,0,49,0,49
2020-10-02,Mid Central,0,32,0,32
2020-10-02,Lakes,0,16,0,16
2020-10-02,Hutt Valley,0,22,0,22
2020-10-02,Hawke's Bay,0,44,0,44
2020-10-02,Counties Manukau,4,209,1,214
2020-10-02,Capital and Coast,0,93,2,95
2020-10-02,Canterbury,0,152,12,164
2020-10-02,Bay of Plenty,0,48,0,48
2020-10-02,Managed Isolation & Quarantine,42,106,0,148
2020-10-02,Total,53,1770,25,1848
2020-10-03,Auckland,2,223,1,226
2020-10-03,Whanganui,0,9,0,9
2020-10-03,West Coast,0,4,1,5
2020-10-03,Waitemata,3,286,4,293
2020-10-03,Wairarapa,0,8,0,8
2020-10-03,Waikato,0,192,2,194
2020-10-03,Taranaki,0,16,0,16
2020-10-03,Tairawhiti,0,4,0,4
2020-10-03,Southern,0,214,2,216
2020-10-03,South Canterbury,0,17,0,17
2020-10-03,Northland,0,28,0,28
2020-10-03,Nelson Marlborough,0,49,0,49
2020-10-03,Mid Central,0,32,0,32
2020-10-03,Lakes,0,16,0,16
2020-10-03,Hutt Valley,0,22,0,22
2020-10-03,Hawke's Bay,0,44,0,44
2020-10-03,Counties Manukau,3,210,1,214
2020-10-03,Capital and Coast,0,93,2,95
2020-10-03,Canterbury,0,152,12,164
2020-10-03,Bay of Plenty,0,48,0,48
2020-10-03,Managed Isolation & Quarantine,33,116,0,149
2020-10-03,Total,41,1783,25,1849
2020-10-04,Auckland,1,224,1,226
2020-10-04,Whanganui,0,9,0,9
2020-10-04,West Coast,0,4,1,5
2020-10-04,Waitemata,3,286,4,293
2020-10-04,Wairarapa,0,8,0,8
2020-10-04,Waikato,0,192,2,194
2020-10-04,Taranaki,0,16,0,16
2020-10-04,Tairawhiti,0,4,0,4
2020-10-04,Southern,0,214,2,216
2020-10-04,South Canterbury,0,17,0,17
2020-10-04,Northland,0,28,0,28
2020-10-04,Nelson Marlborough,0,49,0,49
2020-10-04,Mid Central,0,32,0,32
2020-10-04,Lakes,0,16,0,16
2020-10-04,Hutt Valley,0,22,0,22
2020-10-04,Hawke's Bay,0,44,0,44
2020-10-04,Counties Manukau,3,210,1,214
2020-10-04,Capital and Coast,0,93,2,95
2020-10-04,Canterbury,0,152,12,164
2020-10-04,Bay of Plenty,0,48,0,48
2020-10-04,Managed Isolation & Quarantine,34,120,0,154
2020-10-04,Total,41,1788,25,1854
2020-10-05,Auckland,1,224,1,226
2020-10-05,Whanganui,0,9,0,9
2020-10-05,West Coast,0,4,1,5
2020-10-05,Waitemata,2,287,4,293
2020-10-05,Wairarapa,0,8,0,8
2020-10-05,Waikato,0,192,2,194
2020-10-05,Taranaki,0,16,0,16
2020-10-05,Tairawhiti,0,4,0,4
2020-10-05,Southern,0,214,2,216
2020-10-05,South Canterbury,0,17,0,17
2020-10-05,Northland,0,28,0,28
2020-10-05,Nelson Marlborough,0,49,0,49
2020-10-05,Mid Central,0,32,0,32
2020-10-05,Lakes,0,16,0,16
2020-10-05,Hutt Valley,0,22,0,22
2020-10-05,Hawke's Bay,0,44,0,44
2020-10-05,Counties Manukau,3,210,1,214
2020-10-05,Capital and Coast,0,93,2,95
2020-10-05,Canterbury,0,152,12,164
2020-10-05,Bay of Plenty,0,48,0,48
2020-10-05,Managed Isolation & Quarantine,34,121,0,155
2020-10-05,Total,40,1790,25,1855
2020-10-06,Auckland,1,224,1,226
2020-10-06,Whanganui,0,9,0,9
2020-10-06,West Coast,0,4,1,5
2020-10-06,Waitemata,2,287,4,293
2020-10-06,Wairarapa,0,8,0,8
2020-10-06,Waikato,0,192,2,194
2020-10-06,Taranaki,0,16,0,16
2020-10-06,Tairawhiti,0,4,0,4
2020-10-06,Southern,0,214,2,216
2020-10-06,South Canterbury,0,17,0,17
2020-10-06,Northland,0,28,0,28
2020-10-06,Nelson Marlborough,0,49,0,49
2020-10-06,Mid Central,0,32,0,32
2020-10-06,Lakes,0,16,0,16
2020-10-06,Hutt Valley,0,22,0,22
2020-10-06,Hawke's Bay,0,44,0,44
2020-10-06,Counties Manukau,3,210,1,214
2020-10-06,Capital and Coast,0,93,2,95
2020-10-06,Canterbury,0,152,12,164
2020-10-06,Bay of Plenty,0,48,0,48
2020-10-06,Managed Isolation & Quarantine,37,121,0,158
2020-10-06,Total,43,1790,25,1858
2020-10-07,Auckland,0,225,1,226
2020-10-07,Whanganui,0,9,0,9
2020-10-07,West Coast,0,4,1,5
2020-10-07,Waitemata,0,289,4,293
2020-10-07,Wairarapa,0,8,0,8
2020-10-07,Waikato,0,192,2,194
2020-10-07,Taranaki,0,16,0,16
2020-10-07,Tairawhiti,0,4,0,4
2020-10-07,Southern,0,214,2,216
2020-10-07,South Canterbury,0,17,0,17
2020-10-07,Northland,0,28,0,28
2020-10-07,Nelson Marlborough,0,49,0,49
2020-10-07,Mid Central,0,32,0,32
2020-10-07,Lakes,0,16,0,16
2020-10-07,Hutt Valley,0,22,0,22
2020-10-07,Hawke's Bay,0,44,0,44
2020-10-07,Counties Manukau,0,213,1,214
2020-10-07,Capital and Coast,0,93,2,95
2020-10-07,Canterbury,0,152,12,164
2020-10-07,Bay of Plenty,0,48,0,48
2020-10-07,Managed Isolation & Quarantine,37,124,0,161
2020-10-07,Total,37,1799,25,1861
2020-10-08,Auckland,0,225,1,226
2020-10-08,Whanganui,0,9,0,9
2020-10-08,West Coast,0,4,1,5
2020-10-08,Waitemata,0,289,4,293
2020-10-08,Wairarapa,0,8,0,8
2020-10-08,Waikato,0,192,2,194
2020-10-08,Taranaki,0,16,0,16
2020-10-08,Tairawhiti,0,4,0,4
2020-10-08,Southern,0,214,2,216
2020-10-08,South Canterbury,0,17,0,17
2020-10-08,Northland,0,28,0,28
2020-10-08,Nelson Marlborough,0,49,0,49
2020-10-08,Mid Central,0,32,0,32
2020-10-08,Lakes,0,16,0,16
2020-10-08,Hutt Valley,0,22,0,22
2020-10-08,Hawke's Bay,0,44,0,44
2020-10-08,Counties Manukau,0,213,1,214
2020-10-08,Capital and Coast,0,93,2,95
2020-10-08,Canterbury,0,153,12,165
2020-10-08,Bay of Plenty,0,48,0,48
2020-10-08,Managed Isolation & Quarantine,39,124,0,161
2020-10-08,Total,39,1800,25,1864
2020-10-09,Auckland,0,225,1,226
2020-10-09,Whanganui,0,9,0,9
2020-10-09,West Coast,0,4,1,5
2020-10-09,Waitemata,0,289,4,293
2020-10-09,Wairarapa,0,8,0,8
2020-10-09,Waikato,0,192,2,194
2020-10-09,Taranaki,0,16,0,16
2020-10-09,Tairawhiti,0,4,0,4
2020-10-09,Southern,0,214,2,216
2020-10-09,South Canterbury,0,17,0,17
2020-10-09,Northland,0,28,0,28
2020-10-09,Nelson Marlborough,0,49,0,49
2020-10-09,Mid Central,0,32,0,32
2020-10-09,Lakes,0,16,0,16
2020-10-09,Hutt Valley,0,22,0,22
2020-10-09,Hawke's Bay,0,44,0,44
2020-10-09,Counties Manukau,0,213,1,214
2020-10-09,Capital and Coast,0,93,2,95
2020-10-09,Canterbury,0,153,12,165
2020-10-09,Bay of Plenty,0,48,0,48
2020-10-09,Managed Isolation & Quarantine,41,124,0,165
2020-10-09,Total,41,1800,25,1866
2020-10-10,Auckland,0,225,1,226
2020-10-10,Whanganui,0,9,0,9
2020-10-10,West Coast,0,4,1,5
2020-10-10,Waitemata,0,289,4,293
2020-10-10,Wairarapa,0,8,0,8
2020-10-10,Waikato,0,192,2,194
2020-10-10,Taranaki,0,16,0,16
2020-10-10,Tairawhiti,0,4,0,4
2020-10-10,Southern,0,214,2,216
2020-10-10,South Canterbury,0,17,0,17
2020-10-10,Northland,0,28,0,28
2020-10-10,Nelson Marlborough,0,49,0,49
2020-10-10,Mid Central,0,32,0,32
2020-10-10,Lakes,0,16,0,16
2020-10-10,Hutt Valley,0,22,0,22
2020-10-10,Hawke's Bay,0,44,0,44
2020-10-10,Counties Manukau,0,213,1,214
2020-10-10,Capital and Coast,0,93,2,95
2020-10-10,Canterbury,0,153,12,165
2020-10-10,Bay of Plenty,0,48,0,48
2020-10-10,Managed Isolation & Quarantine,44,125,0,169
2020-10-10,Total,44,1801,25,1870
2020-10-11,Auckland,0,225,1,226
2020-10-11,Whanganui,0,9,0,9
2020-10-11,West Coast,0,4,1,5
2020-10-11,Waitemata,0,289,4,293
2020-10-11,Wairarapa,0,8,0,8
2020-10-11,Waikato,0,192,2,194
2020-10-11,Taranaki,0,16,0,16
2020-10-11,Tairawhiti,0,4,0,4
2020-10-11,Southern,0,214,2,216
2020-10-11,South Canterbury,0,17,0,17
2020-10-11,Northland,0,28,0,28
2020-10-11,Nelson Marlborough,0,49,0,49
2020-10-11,Mid Central,0,32,0,32
2020-10-11,Lakes,0,16,0,16
2020-10-11,Hutt Valley,0,22,0,22
2020-10-11,Hawke's Bay,0,44,0,44
2020-10-11,Counties Manukau,0,213,1,214
2020-10-11,Capital and Coast,0,93,2,95
2020-10-11,Canterbury,0,153,12,165
2020-10-11,Bay of Plenty,0,48,0,48
2020-10-11,Managed Isolation & Quarantine,45,125,0,170
2020-10-11,Total,45,1801,25,1871
2020-10-12,Auckland,0,225,1,226
2020-10-12,Whanganui,0,9,0,9
2020-10-12,West Coast,0,4,1,5
2020-10-12,Waitemata,0,289,4,293
2020-10-12,Wairarapa,0,8,0,8
2020-10-12,Waikato,0,192,2,194
2020-10-12,Taranaki,0,16,0,16
2020-10-12,Tairawhiti,0,4,0,4
2020-10-12,Southern,0,214,2,216
2020-10-12,South Canterbury,0,17,0,17
2020-10-12,Northland,0,28,0,28
2020-10-12,Nelson Marlborough,0,49,0,49
2020-10-12,Mid Central,0,32,0,32
2020-10-12,Lakes,0,16,0,16
2020-10-12,Hutt Valley,0,22,0,22
2020-10-12,Hawke's Bay,0,44,0,44
2020-10-12,Counties Manukau,0,213,1,214
2020-10-12,Capital and Coast,0,93,2,95
2020-10-12,Canterbury,0,153,12,165
2020-10-12,Bay of Plenty,0,48,0,48
2020-10-12,Managed Isolation & Quarantine,45,125,0,170
2020-10-12,Total,45,1801,25,1871
2020-10-13,Auckland,0,225,1,226
2020-10-13,Whanganui,0,9,0,9
2020-10-13,West Coast,0,4,1,5
2020-10-13,Waitemata,0,289,4,293
2020-10-13,Wairarapa,0,8,0,8
2020-10-13,Waikato,0,192,2,194
2020-10-13,Taranaki,0,16,0,16
2020-10-13,Tairawhiti,0,4,0,4
2020-10-13,Southern,0,214,2,216
2020-10-13,South Canterbury,0,17,0,17
2020-10-13,Northland,0,28,0,28
2020-10-13,Nelson Marlborough,0,49,0,49
2020-10-13,Mid Central,0,32,0,32
2020-10-13,Lakes,0,16,0,16
2020-10-13,Hutt Valley,0,22,0,22
2020-10-13,Hawke's Bay,0,44,0,44
2020-10-13,Counties Manukau,0,213,1,214
2020-10-13,Capital and Coast,0,93,2,95
2020-10-13,Canterbury,0,153,12,165
2020-10-13,Bay of Plenty,0,48,0,48
2020-10-13,Managed Isolation & Quarantine,39,132,0,171
2020-10-13,Total,39,1808,25,1872
2020-10-14,Auckland,0,225,1,226
2020-10-14,Whanganui,0,9,0,9
2020-10-14,West Coast,0,4,1,5
2020-10-14,Waitemata,0,289,4,293
2020-10-14,Wairarapa,0,8,0,8
2020-10-14,Waikato,0,192,2,194
2020-10-14,Taranaki,0,16,0,16
2020-10-14,Tairawhiti,0,4,0,4
2020-10-14,Southern,0,214,2,216
2020-10-14,South Canterbury,0,17,0,17
2020-10-14,Northland,0,28,0,28
2020-10-14,Nelson Marlborough,0,49,0,49
2020-10-14,Mid Central,0,32,0,32
2020-10-14,Lakes,0,16,0,16
2020-10-14,Hutt Valley,0,22,0,22
2020-10-14,Hawke's Bay,0,44,0,44
2020-10-14,Counties Manukau,0,213,1,214
2020-10-14,Capital and Coast,0,93,2,95
2020-10-14,Canterbury,0,153,12,165
2020-10-14,Bay of Plenty,0,48,0,48
2020-10-14,Managed Isolation & Quarantine,40,133,0,173
2020-10-14,Total,40,1809,25,1874
2020-10-15,Auckland,0,225,1,226
2020-10-15,Whanganui,0,9,0,9
2020-10-15,West Coast,0,4,1,5
2020-10-15,Waitemata,0,289,4,293
2020-10-15,Wairarapa,0,8,0,8
2020-10-15,Waikato,0,192,2,194
2020-10-15,Taranaki,0,16,0,16
2020-10-15,Tairawhiti,0,4,0,4
2020-10-15,Southern,0,214,2,216
2020-10-15,South Canterbury,0,17,0,17
2020-10-15,Northland,0,28,0,28
2020-10-15,Nelson Marlborough,0,49,0,49
2020-10-15,Mid Central,0,32,0,32
2020-10-15,Lakes,0,16,0,16
2020-10-15,Hutt Valley,0,22,0,22
2020-10-15,Hawke's Bay,0,44,0,44
2020-10-15,Counties Manukau,0,213,1,214
2020-10-15,Capital and Coast,0,93,2,95
2020-10-15,Canterbury,0,153,12,165
2020-10-15,Bay of Plenty,0,48,0,48
2020-10-15,Managed Isolation & Quarantine,42,133,0,175
2020-10-15,Total,42,1809,25,1876
2020-10-16,Auckland,0,225,1,226
2020-10-16,Whanganui,0,9,0,9
2020-10-16,West Coast,0,4,1,5
2020-10-16,Waitemata,0,289,4,293
2020-10-16,Wairarapa,0,8,0,8
2020-10-16,Waikato,0,192,2,194
2020-10-16,Taranaki,0,16,0,16
2020-10-16,Tairawhiti,0,4,0,4
2020-10-16,Southern,0,214,2,216
2020-10-16,South Canterbury,0,17,0,17
2020-10-16,Northland,0,28,0,28
2020-10-16,Nelson Marlborough,0,49,0,49
2020-10-16,Mid Central,0,32,0,32
2020-10-16,Lakes,0,16,0,16
2020-10-16,Hutt Valley,0,22,0,22
2020-10-16,Hawke's Bay,0,44,0,44
2020-10-16,Counties Manukau,0,213,1,214
2020-10-16,Capital and Coast,0,93,2,95
2020-10-16,Canterbury,0,153,12,165
2020-10-16,Bay of Plenty,0,48,0,48
2020-10-16,Managed Isolation & Quarantine,46,133,0,179
2020-10-16,Total,46,1809,25,1880
2020-10-17,Auckland,0,225,1,226
2020-10-17,Whanganui,0,9,0,9
2020-10-17,West Coast,0,4,1,5
2020-10-17,Waitemata,0,289,4,293
2020-10-17,Wairarapa,0,8,0,8
2020-10-17,Waikato,0,192,2,194
2020-10-17,Taranaki,0,16,0,16
2020-10-17,Tairawhiti,0,4,0,4
2020-10-17,Southern,0,214,2,216
2020-10-17,South Canterbury,0,17,0,17
2020-10-17,Northland,0,28,0,28
2020-10-17,Nelson Marlborough,0,49,0,49
2020-10-17,Mid Central,0,32,0,32
2020-10-17,Lakes,0,16,0,16
2020-10-17,Hutt Valley,0,22,0,22
2020-10-17,Hawke's Bay,0,44,0,44
2020-10-17,Counties Manukau,0,213,1,214
2020-10-17,Capital and Coast,0,93,2,95
2020-10-17,Canterbury,0,153,12,165
2020-10-17,Bay of Plenty,0,48,0,48
2020-10-17,Managed Isolation & Quarantine,40,142,0,182
2020-10-17,Total,40,1818,25,1883
2020-10-18,Auckland,0,225,1,226
2020-10-18,Whanganui,0,9,0,9
2020-10-18,West Coast,0,4,1,5
2020-10-18,Waitemata,1,289,4,294
2020-10-18,Wairarapa,0,8,0,8
2020-10-18,Waikato,0,192,2,194
2020-10-18,Taranaki,0,16,0,16
2020-10-18,Tairawhiti,0,4,0,4
2020-10-18,Southern,0,214,2,216
2020-10-18,South Canterbury,0,17,0,17
2020-10-18,Northland,0,28,0,28
2020-10-18,Nelson Marlborough,0,49,0,49
2020-10-18,Mid Central,0,32,0,32
2020-10-18,Lakes,0,16,0,16
2020-10-18,Hutt Valley,0,22,0,22
2020-10-18,Hawke's Bay,0,44,0,44
2020-10-18,Counties Manukau,0,213,1,214
2020-10-18,Capital and Coast,0,94,2,96
2020-10-18,Canterbury,0,153,12,165
2020-10-18,Bay of Plenty,0,48,0,48
2020-10-18,Managed Isolation & Quarantine,41,142,0,183
2020-10-18,Total,42,1819,25,1886
2020-10-19,Auckland,0,225,1,226
2020-10-19,Whanganui,0,9,0,9
2020-10-19,West Coast,0,4,1,5
2020-10-19,Waitemata,1,289,4,294
2020-10-19,Wairarapa,0,8,0,8
2020-10-19,Waikato,0,192,2,194
2020-10-19,Taranaki,0,16,0,16
2020-10-19,Tairawhiti,0,4,0,4
2020-10-19,Southern,0,214,2,216
2020-10-19,South Canterbury,0,17,0,17
2020-10-19,Northland,0,28,0,28
2020-10-19,Nelson Marlborough,0,49,0,49
2020-10-19,Mid Central,0,32,0,32
2020-10-19,Lakes,0,16,0,16
2020-10-19,Hutt Valley,0,22,0,22
2020-10-19,Hawke's Bay,0,44,0,44
2020-10-19,Counties Manukau,0,213,1,214
2020-10-19,Capital and Coast,0,94,2,96
2020-10-19,Canterbury,0,153,12,165
2020-10-19,Bay of Plenty,0,48,0,48
2020-10-19,Managed Isolation & Quarantine,36,147,0,183
2020-10-19,Total,37,1824,25,1886
2020-10-20,Auckland,0,225,1,226
2020-10-20,Whanganui,0,9,0,9
2020-10-20,West Coast,0,4,1,5
2020-10-20,Waitemata,1,289,4,294
2020-10-20,Wairarapa,0,8,0,8
2020-10-20,Waikato,0,192,2,194
2020-10-20,Taranaki,0,16,0,16
2020-10-20,Tairawhiti,0,4,0,4
2020-10-20,Southern,0,214,2,216
2020-10-20,South Canterbury,0,17,0,17
2020-10-20,Northland,0,28,0,28
2020-10-20,Nelson Marlborough,0,49,0,49
2020-10-20,Mid Central,0,32,0,32
2020-10-20,Lakes,0,16,0,16
2020-10-20,Hutt Valley,0,22,0,22
2020-10-20,Hawke's Bay,0,44,0,44
2020-10-20,Counties Manukau,0,213,1,214
2020-10-20,Capital and Coast,0,94,2,96
2020-10-20,Canterbury,0,153,12,165
2020-10-20,Bay of Plenty,0,48,0,48
2020-10-20,Managed Isolation & Quarantine,32,152,0,184
2020-10-20,Total,33,1829,25,1887
2020-10-21,Auckland,0,225,1,226
2020-10-21,Whanganui,0,9,0,9
2020-10-21,West Coast,0,4,1,5
2020-10-21,Waitemata,2,289,4,295
2020-10-21,Wairarapa,0,8,0,8
2020-10-21,Waikato,0,192,2,194
2020-10-21,Taranaki,0,16,0,16
2020-10-21,Tairawhiti,0,4,0,4
2020-10-21,Southern,0,214,2,216
2020-10-21,South Canterbury,0,17,0,17
2020-10-21,Northland,0,28,0,28
2020-10-21,Nelson Marlborough,0,49,0,49
2020-10-21,Mid Central,0,32,0,32
2020-10-21,Lakes,0,16,0,16
2020-10-21,Hutt Valley,0,22,0,22
2020-10-21,Hawke's Bay,0,44,0,44
2020-10-21,Counties Manukau,1,213,1,215
2020-10-21,Capital and Coast,0,94,2,96
2020-10-21,Canterbury,0,153,12,165
2020-10-21,Bay of Plenty,0,48,0,48
2020-10-21,Managed Isolation & Quarantine,53,154,0,207
2020-10-21,Total,56,1831,25,1912
2020-10-22,Auckland,0,225,1,226
2020-10-22,Whanganui,0,9,0,9
2020-10-22,West Coast,0,4,1,5
2020-10-22,Waitemata,2,289,4,295
2020-10-22,Wairarapa,0,8,0,8
2020-10-22,Waikato,0,192,2,194
2020-10-22,Taranaki,0,16,0,16
2020-10-22,Tairawhiti,0,4,0,4
2020-10-22,Southern,0,214,2,216
2020-10-22,South Canterbury,0,17,0,17
2020-10-22,Northland,0,28,0,28
2020-10-22,Nelson Marlborough,0,49,0,49
2020-10-22,Mid Central,0,32,0,32
2020-10-22,Lakes,0,16,0,16
2020-10-22,Hutt Valley,0,22,0,22
2020-10-22,Hawke's Bay,0,44,0,44
2020-10-22,Counties Manukau,1,213,1,215
2020-10-22,Capital and Coast,0,94,2,96
2020-10-22,Canterbury,0,153,12,165
2020-10-22,Bay of Plenty,0,48,0,48
2020-10-22,Managed Isolation & Quarantine,55,154,0,209
2020-10-22,Total,58,1831,25,1914
2020-10-23,Auckland,0,225,1,226
2020-10-23,Whanganui,0,9,0,9
2020-10-23,West Coast,0,4,1,5
2020-10-23,Waitemata,3,289,4,296
2020-10-23,Wairarapa,0,8,0,8
2020-10-23,Waikato,0,192,2,194
2020-10-23,Taranaki,0,16,0,16
2020-10-23,Tairawhiti,0,4,0,4
2020-10-23,Southern,0,214,2,216
2020-10-23,South Canterbury,0,17,0,17
2020-10-23,Northland,0,28,0,28
2020-10-23,Nelson Marlborough,0,49,0,49
2020-10-23,Mid Central,0,32,0,32
2020-10-23,Lakes,0,16,0,16
2020-10-23,Hutt Valley,0,22,0,22
2020-10-23,Hawke's Bay,0,44,0,44
2020-10-23,Counties Manukau,1,213,1,215
2020-10-23,Capital and Coast,0,93,2,95
2020-10-23,Canterbury,0,153,12,165
2020-10-23,Bay of Plenty,0,48,0,48
2020-10-23,Managed Isolation & Quarantine,62,156,0,218
2020-10-23,Total,66,1832,25,1923
2020-10-24,Auckland,0,224,1,225
2020-10-24,Whanganui,0,9,0,9
2020-10-24,West Coast,0,4,1,5
2020-10-24,Waitemata,3,289,4,296
2020-10-24,Wairarapa,0,8,0,8
2020-10-24,Waikato,0,192,2,194
2020-10-24,Taranaki,0,16,0,16
2020-10-24,Tairawhiti,0,4,0,4
2020-10-24,Southern,0,214,2,216
2020-10-24,South Canterbury,0,17,0,17
2020-10-24,Northland,0,28,0,28
2020-10-24,Nelson Marlborough,0,49,0,49
2020-10-24,Mid Central,0,32,0,32
2020-10-24,Lakes,0,16,0,16
2020-10-24,Hutt Valley,0,22,0,22
2020-10-24,Hawke's Bay,0,44,0,44
2020-10-24,Counties Manukau,2,212,1,215
2020-10-24,Capital and Coast,0,93,2,95
2020-10-24,Canterbury,0,152,12,164
2020-10-24,Bay of Plenty,0,48,0,48
2020-10-24,Managed Isolation & Quarantine,69,162,0,231
2020-10-24,Total,74,1835,25,1934
2020-10-25,Auckland,0,224,1,225
2020-10-25,Whanganui,0,9,0,9
2020-10-25,West Coast,0,4,1,5
2020-10-25,Waitemata,3,289,4,296
2020-10-25,Wairarapa,0,8,0,8
2020-10-25,Waikato,0,192,2,194
2020-10-25,Taranaki,0,16,0,16
2020-10-25,Tairawhiti,0,4,0,4
2020-10-25,Southern,0,214,2,216
2020-10-25,South Canterbury,0,17,0,17
2020-10-25,Northland,0,28,0,28
2020-10-25,Nelson Marlborough,0,49,0,49
2020-10-25,Mid Central,0,32,0,32
2020-10-25,Lakes,0,16,0,16
2020-10-25,Hutt Valley,0,22,0,22
2020-10-25,Hawke's Bay,0,44,0,44
2020-10-25,Counties Manukau,1,212,1,214
2020-10-25,Capital and Coast,0,93,2,95
2020-10-25,Canterbury,0,152,12,164
2020-10-25,Bay of Plenty,0,48,0,48
2020-10-25,Managed Isolation & Quarantine,66,167,0,233
2020-10-25,Total,70,1840,25,1935
2020-10-26,Auckland,0,224,1,225
2020-10-26,Whanganui,0,9,0,9
2020-10-26,West Coast,0,4,1,5
2020-10-26,Waitemata,3,289,4,296
2020-10-26,Wairarapa,0,8,0,8
2020-10-26,Waikato,0,192,2,194
2020-10-26,Taranaki,0,16,0,16
2020-10-26,Tairawhiti,0,4,0,4
2020-10-26,Southern,0,214,2,216
2020-10-26,South Canterbury,0,17,0,17
2020-10-26,Northland,0,28,0,28
2020-10-26,Nelson Marlborough,0,49,0,49
2020-10-26,Mid Central,0,32,0,32
2020-10-26,Lakes,0,16,0,16
2020-10-26,Hutt Valley,0,22,0,22
2020-10-26,Hawke's Bay,0,44,0,44
2020-10-26,Counties Manukau,1,212,1,214
2020-10-26,Capital and Coast,0,93,2,95
2020-10-26,Canterbury,0,152,12,164
2020-10-26,Bay of Plenty,0,48,0,48
2020-10-26,Managed Isolation & Quarantine,70,168,0,238
2020-10-26,Total,74,1841,25,1940
2020-10-27,Auckland,0,225,1,226
2020-10-27,Whanganui,0,9,0,9
2020-10-27,West Coast,0,4,1,5
2020-10-27,Waitemata,3,289,4,296
2020-10-27,Wairarapa,0,8,0,8
2020-10-27,Waikato,0,192,2,194
2020-10-27,Taranaki,0,16,0,16
2020-10-27,Tairawhiti,0,4,0,4
2020-10-27,Southern,0,214,2,216
2020-10-27,South Canterbury,0,17,0,17
2020-10-27,Northland,0,28,0,28
2020-10-27,Nelson Marlborough,0,49,0,49
2020-10-27,Mid Central,0,32,0,32
2020-10-27,Lakes,0,16,0,16
2020-10-27,Hutt Valley,0,22,0,22
2020-10-27,Hawke's Bay,0,44,0,44
2020-10-27,Counties Manukau,1,213,1,215
2020-10-27,Capital and Coast,0,93,2,95
2020-10-27,Canterbury,0,153,12,165
2020-10-27,Bay of Plenty,0,48,0,48
2020-10-27,Managed Isolation & Quarantine,64,172,0,236
2020-10-27,Total,68,1848,25,1941
2020-10-28,Auckland,0,225,1,226
2020-10-28,Whanganui,0,9,0,9
2020-10-28,West Coast,0,4,1,5
2020-10-28,Waitemata,3,289,4,296
2020-10-28,Wairarapa,0,8,0,8
2020-10-28,Waikato,0,192,2,194
2020-10-28,Taranaki,0,16,0,16
2020-10-28,Tairawhiti,0,4,0,4
2020-10-28,Southern,0,214,2,216
2020-10-28,South Canterbury,0,17,0,17
2020-10-28,Northland,0,28,0,28
2020-10-28,Nelson Marlborough,0,49,0,49
2020-10-28,Mid Central,0,32,0,32
2020-10-28,Lakes,0,16,0,16
2020-10-28,Hutt Valley,0,22,0,22
2020-10-28,Hawke's Bay,0,44,0,44
2020-10-28,Counties Manukau,1,213,1,215
2020-10-28,Capital and Coast,0,93,2,95
2020-10-28,Canterbury,0,153,12,165
2020-10-28,Bay of Plenty,0,48,0,48
2020-10-28,Managed Isolation & Quarantine,62,176,0,238
2020-10-28,Total,68,1852,25,1943
2020-10-29,Auckland,0,225,1,226
2020-10-29,Whanganui,0,9,0,9
2020-10-29,West Coast,0,4,1,5
2020-10-29,Waitemata,3,289,4,296
2020-10-29,Wairarapa,0,8,0,8
2020-10-29,Waikato,0,192,2,194
2020-10-29,Taranaki,0,16,0,16
2020-10-29,Tairawhiti,0,4,0,4
2020-10-29,Southern,0,214,2,216
2020-10-29,South Canterbury,0,17,0,17
2020-10-29,Northland,0,28,0,28
2020-10-29,Nelson Marlborough,0,49,0,49
2020-10-29,Mid Central,0,32,0,32
2020-10-29,Lakes,0,16,0,16
2020-10-29,Hutt Valley,0,22,0,22
2020-10-29,Hawke's Bay,0,44,0,44
2020-10-29,Counties Manukau,1,213,1,215
2020-10-29,Capital and Coast,0,93,2,95
2020-10-29,Canterbury,0,153,12,165
2020-10-29,Bay of Plenty,0,48,0,48
2020-10-29,Managed Isolation & Quarantine,66,178,0,244
2020-10-29,Total,70,1854,25,1949
2020-10-30,Auckland,0,225,1,226
2020-10-30,Whanganui,0,9,0,9
2020-10-30,West Coast,0,4,1,5
2020-10-30,Waitemata,3,289,4,296
2020-10-30,Wairarapa,0,8,0,8
2020-10-30,Waikato,0,192,2,194
2020-10-30,Taranaki,0,16,0,16
2020-10-30,Tairawhiti,0,4,0,4
2020-10-30,Southern,0,214,2,216
2020-10-30,South Canterbury,0,17,0,17
2020-10-30,Northland,0,28,0,28
2020-10-30,Nelson Marlborough,0,49,0,49
2020-10-30,Mid Central,0,32,0,32
2020-10-30,Lakes,0,16,0,16
2020-10-30,Hutt Valley,0,22,0,22
2020-10-30,Hawke's Bay,0,44,0,44
2020-10-30,Counties Manukau,1,213,1,215
2020-10-30,Capital and Coast,0,93,2,95
2020-10-30,Canterbury,0,153,12,165
2020-10-30,Bay of Plenty,0,48,0,48
2020-10-30,Managed Isolation & Quarantine,64,181,0,245
2020-10-30,Total,68,1857,25,1950
2020-10-31,Auckland,0,225,1,226
2020-10-31,Whanganui,0,9,0,9
2020-10-31,West Coast,0,4,1,5
2020-10-31,Waitemata,3,289,4,296
2020-10-31,Wairarapa,0,8,0,8
2020-10-31,Waikato,0,192,2,194
2020-10-31,Taranaki,0,16,0,16
2020-10-31,Tairawhiti,0,4,0,4
2020-10-31,Southern,0,214,2,216
2020-10-31,South Canterbury,0,17,0,17
2020-10-31,Northland,0,28,0,28
2020-10-31,Nelson Marlborough,0,49,0,49
2020-10-31,Mid Central,0,32,0,32
2020-10-31,Lakes,0,16,0,16
2020-10-31,Hutt Valley,0,22,0,22
2020-10-31,Hawke's Bay,0,44,0,44
2020-10-31,Counties Manukau,1,213,1,215
2020-10-31,Capital and Coast,0,93,2,95
2020-10-31,Canterbury,0,153,12,165
2020-10-31,Bay of Plenty,0,48,0,48
2020-10-31,Managed Isolation & Quarantine,71,181,0,252
2020-10-31,Total,75,1857,25,1957
2020-11-01,Auckland,0,225,1,226
2020-11-01,Whanganui,0,9,0,9
2020-11-01,West Coast,0,4,1,5
2020-11-01,Waitemata,3,289,4,296
2020-11-01,Wairarapa,0,8,0,8
2020-11-01,Waikato,0,192,2,194
2020-11-01,Taranaki,0,16,0,16
2020-11-01,Tairawhiti,0,4,0,4
2020-11-01,Southern,0,214,2,216
2020-11-01,South Canterbury,0,17,0,17
2020-11-01,Northland,0,28,0,28
2020-11-01,Nelson Marlborough,0,49,0,49
2020-11-01,Mid Central,0,32,0,32
2020-11-01,Lakes,0,16,0,16
2020-11-01,Hutt Valley,0,22,0,22
2020-11-01,Hawke's Bay,0,44,0,44
2020-11-01,Counties Manukau,1,213,1,215
2020-11-01,Capital and Coast,0,93,2,95
2020-11-01,Canterbury,0,153,12,165
2020-11-01,Bay of Plenty,0,48,0,48
2020-11-01,Managed Isolation & Quarantine,73,181,0,254
2020-11-01,Total,77,1857,25,1959
2020-11-02,Auckland,0,225,1,226
2020-11-02,Whanganui,0,9,0,9
2020-11-02,West Coast,0,4,1,5
2020-11-02,Waitemata,3,289,4,296
2020-11-02,Wairarapa,0,8,0,8
2020-11-02,Waikato,0,192,2,194
2020-11-02,Taranaki,0,16,0,16
2020-11-02,Tairawhiti,0,4,0,4
2020-11-02,Southern,0,214,2,216
2020-11-02,South Canterbury,0,17,0,17
2020-11-02,Northland,0,28,0,28
2020-11-02,Nelson Marlborough,0,49,0,49
2020-11-02,Mid Central,0,32,0,32
2020-11-02,Lakes,0,16,0,16
2020-11-02,Hutt Valley,0,22,0,22
2020-11-02,Hawke's Bay,0,44,0,44
2020-11-02,Counties Manukau,1,213,1,215
2020-11-02,Capital and Coast,0,93,2,95
2020-11-02,Canterbury,0,153,12,165
2020-11-02,Bay of Plenty,0,48,0,48
2020-11-02,Managed Isolation & Quarantine,73,181,0,254
2020-11-02,Total,81,1857,25,1963
2020-11-03,Auckland,0,225,1,226
2020-11-03,Whanganui,0,9,0,9
2020-11-03,West Coast,0,4,1,5
2020-11-03,Waitemata,1,291,4,296
2020-11-03,Wairarapa,0,8,0,8
2020-11-03,Waikato,0,192,2,194
2020-11-03,Taranaki,0,16,0,16
2020-11-03,Tairawhiti,0,4,0,4
2020-11-03,Southern,0,214,2,216
2020-11-03,South Canterbury,0,17,0,17
2020-11-03,Northland,0,28,0,28
2020-11-03,Nelson Marlborough,0,49,0,49
2020-11-03,Mid Central,0,32,0,32
2020-11-03,Lakes,0,16,0,16
2020-11-03,Hutt Valley,0,22,0,22
2020-11-03,Hawke's Bay,0,44,0,44
2020-11-03,Counties Manukau,0,214,1,215
2020-11-03,Capital and Coast,0,93,2,95
2020-11-03,Canterbury,1,153,12,166
2020-11-03,Bay of Plenty,0,48,0,48
2020-11-03,Managed Isolation & Quarantine,73,189,0,262
2020-11-03,Total,75,1868,25,1968
2020-11-04,Auckland,0,225,1,226
2020-11-04,Whanganui,0,9,0,9
2020-11-04,West Coast,0,4,1,5
2020-11-04,Waitemata,1,291,4,296
2020-11-04,Wairarapa,0,8,0,8
2020-11-04,Waikato,0,192,2,194
2020-11-04,Taranaki,0,16,0,16
2020-11-04,Tairawhiti,0,4,0,4
2020-11-04,Southern,0,214,2,216
2020-11-04,South Canterbury,0,17,0,17
2020-11-04,Northland,0,28,0,28
2020-11-04,Nelson Marlborough,0,49,0,49
2020-11-04,Mid Central,0,32,0,32
2020-11-04,Lakes,0,16,0,16
2020-11-04,Hutt Valley,0,22,0,22
2020-11-04,Hawke's Bay,0,44,0,44
2020-11-04,Counties Manukau,0,214,1,215
2020-11-04,Capital and Coast,0,93,2,95
2020-11-04,Canterbury,2,153,12,167
2020-11-04,Bay of Plenty,0,48,0,48
2020-11-04,Managed Isolation & Quarantine,70,194,0,264
2020-11-04,Total,73,1873,25,1971
2020-11-10,Auckland,1,225,1,227
2020-11-10,Whanganui,0,9,0,9
2020-11-10,West Coast,0,4,1,5
2020-11-10,Waitemata,0,292,4,296
2020-11-10,Wairarapa,0,8,0,8
2020-11-10,Waikato,0,192,2,194
2020-11-10,Taranaki,0,16,0,16
2020-11-10,Tairawhiti,0,4,0,4
2020-11-10,Southern,0,214,2,216
2020-11-10,South Canterbury,0,17,0,17
2020-11-10,Northland,0,28,0,28
2020-11-10,Nelson Marlborough,0,49,0,49
2020-11-10,Mid Central,0,32,0,32
2020-11-10,Lakes,0,16,0,16
2020-11-10,Hutt Valley,1,22,0,23
2020-11-10,Hawke's Bay,0,44,0,44
2020-11-10,Counties Manukau,0,214,1,215
2020-11-10,Capital and Coast,0,93,2,95
2020-11-10,Canterbury,2,153,12,167
2020-11-10,Bay of Plenty,0,48,0,48
2020-11-10,Managed Isolation & Quarantine,48,230,0,278
2020-11-10,Total,52,1910,25,1987
2020-11-11,Auckland,1,225,1,227
2020-11-11,Whanganui,0,9,0,9
2020-11-11,West Coast,0,4,1,5
2020-11-11,Waitemata,0,292,4,296
2020-11-11,Wairarapa,0,8,0,8
2020-11-11,Waikato,0,192,2,194
2020-11-11,Taranaki,0,16,0,16
2020-11-11,Tairawhiti,0,4,0,4
2020-11-11,Southern,0,214,2,216
2020-11-11,South Canterbury,0,17,0,17
2020-11-11,Northland,0,28,0,28
2020-11-11,Nelson Marlborough,0,49,0,49
2020-11-11,Mid Central,0,32,0,32
2020-11-11,Lakes,0,16,0,16
2020-11-11,Hutt Valley,1,22,0,23
2020-11-11,Hawke's Bay,0,44,0,44
2020-11-11,Counties Manukau,0,214,1,215
2020-11-11,Capital and Coast,0,93,2,95
2020-11-11,Canterbury,2,153,12,167
2020-11-11,Bay of Plenty,0,48,0,48
2020-11-11,Managed Isolation & Quarantine,48,231,0,279
2020-11-11,Total,52,1911,25,1988
2020-11-12,Auckland,2,225,1,228
2020-11-12,Whanganui,0,9,0,9
2020-11-12,West Coast,0,4,1,5
2020-11-12,Waitemata,0,292,4,296
2020-11-12,Wairarapa,0,8,0,8
2020-11-12,Waikato,0,192,2,194
2020-11-12,Taranaki,0,16,0,16
2020-11-12,Tairawhiti,0,4,0,4
2020-11-12,Southern,0,214,2,216
2020-11-12,South Canterbury,0,17,0,17
2020-11-12,Northland,0,28,0,28
2020-11-12,Nelson Marlborough,0,49,0,49
2020-11-12,Mid Central,0,32,0,32
2020-11-12,Lakes,0,16,0,16
2020-11-12,Hutt Valley,2,22,0,24
2020-11-12,Hawke's Bay,0,44,0,44
2020-11-12,Counties Manukau,0,214,1,215
2020-11-12,Capital and Coast,0,93,2,95
2020-11-12,Canterbury,2,153,12,167
2020-11-12,Bay of Plenty,0,48,0,48
2020-11-12,Managed Isolation & Quarantine,47,233,0,280
2020-11-12,Total,53,1913,25,1991
2020-11-13,Auckland,2,225,1,228
2020-11-13,Whanganui,0,9,0,9
2020-11-13,West Coast,0,4,1,5
2020-11-13,Waitemata,0,292,4,296
2020-11-13,Wairarapa,0,8,0,8
2020-11-13,Waikato,0,192,2,194
2020-11-13,Taranaki,0,16,0,16
2020-11-13,Tairawhiti,0,4,0,4
2020-11-13,Southern,0,214,2,216
2020-11-13,South Canterbury,0,17,0,17
2020-11-13,Northland,0,28,0,28
2020-11-13,Nelson Marlborough,0,49,0,49
2020-11-13,Mid Central,0,32,0,32
2020-11-13,Lakes,0,16,0,16
2020-11-13,Hutt Valley,1,22,0,23
2020-11-13,Hawke's Bay,0,44,0,44
2020-11-13,Counties Manukau,0,214,1,215
2020-11-13,Capital and Coast,1,93,2,96
2020-11-13,Canterbury,1,154,12,167
2020-11-13,Bay of Plenty,0,48,0,48
2020-11-13,Managed Isolation & Quarantine,48,236,0,284
2020-11-13,Total,53,1917,25,1995
2020-11-14,Auckland,2,225,1,228
2020-11-14,Whanganui,0,9,0,9
2020-11-14,West Coast,0,4,1,5
2020-11-14,Waitemata,0,292,4,296
2020-11-14,Wairarapa,0,8,0,8
2020-11-14,Waikato,0,192,2,194
2020-11-14,Taranaki,0,16,0,16
2020-11-14,Tairawhiti,0,4,0,4
2020-11-14,Southern,0,214,2,216
2020-11-14,South Canterbury,0,17,0,17
2020-11-14,Northland,0,28,0,28
2020-11-14,Nelson Marlborough,0,49,0,49
2020-11-14,Mid Central,0,32,0,32
2020-11-14,Lakes,0,16,0,16
2020-11-14,Hutt Valley,1,22,0,23
2020-11-14,Hawke's Bay,0,44,0,44
2020-11-14,Counties Manukau,0,214,1,215
2020-11-14,Capital and Coast,1,93,2,96
2020-11-14,Canterbury,0,155,12,167
2020-11-14,Bay of Plenty,0,48,0,48
2020-11-14,Managed Isolation & Quarantine,51,236,0,287
2020-11-14,Total,55,1918,25,1998
2020-11-15,Auckland,2,225,1,228
2020-11-15,Whanganui,0,9,0,9
2020-11-15,West Coast,0,4,1,5
2020-11-15,Waitemata,0,292,4,296
2020-11-15,Wairarapa,0,8,0,8
2020-11-15,Waikato,0,192,2,194
2020-11-15,Taranaki,0,16,0,16
2020-11-15,Tairawhiti,0,4,0,4
2020-11-15,Southern,0,214,2,216
2020-11-15,South Canterbury,0,17,0,17
2020-11-15,Northland,0,28,0,28
2020-11-15,Nelson Marlborough,0,49,0,49
2020-11-15,Mid Central,0,32,0,32
2020-11-15,Lakes,0,16,0,16
2020-11-15,Hutt Valley,1,22,0,23
2020-11-15,Hawke's Bay,0,44,0,44
2020-11-15,Counties Manukau,1,214,1,216
2020-11-15,Capital and Coast,1,93,2,96
2020-11-15,Canterbury,0,155,12,167
2020-11-15,Bay of Plenty,0,48,0,48
2020-11-15,Managed Isolation & Quarantine,53,236,0,289
2020-11-15,Total,58,1918,25,2001
2020-11-16,Auckland,2,225,1,228
2020-11-16,Whanganui,0,9,0,9
2020-11-16,West Coast,0,4,1,5
2020-11-16,Waitemata,0,292,4,296
2020-11-16,Wairarapa,0,8,0,8
2020-11-16,Waikato,0,192,2,194
2020-11-16,Taranaki,0,16,0,16
2020-11-16,Tairawhiti,0,4,0,4
2020-11-16,Southern,0,214,2,216
2020-11-16,South Canterbury,0,17,0,17
2020-11-16,Northland,0,28,0,28
2020-11-16,Nelson Marlborough,0,49,0,49
2020-11-16,Mid Central,0,32,0,32
2020-11-16,Lakes,0,16,0,16
2020-11-16,Hutt Valley,1,22,0,23
2020-11-16,Hawke's Bay,0,44,0,44
2020-11-16,Counties Manukau,1,214,1,216
2020-11-16,Capital and Coast,1,93,2,96
2020-11-16,Canterbury,0,155,12,167
2020-11-16,Bay of Plenty,0,48,0,48
2020-11-16,Managed Isolation & Quarantine,53,236,0,289
2020-11-16,Total,58,1918,25,2001
2020-11-17,Auckland,1,226,1,228
2020-11-17,Whanganui,0,9,0,9
2020-11-17,West Coast,0,4,1,5
2020-11-17,Waitemata,0,292,4,296
2020-11-17,Wairarapa,0,8,0,8
2020-11-17,Waikato,0,192,2,194
2020-11-17,Taranaki,0,16,0,16
2020-11-17,Tairawhiti,0,4,0,4
2020-11-17,Southern,0,214,2,216
2020-11-17,South Canterbury,0,17,0,17
2020-11-17,Northland,0,28,0,28
2020-11-17,Nelson Marlborough,0,49,0,49
2020-11-17,Mid Central,0,32,0,32
2020-11-17,Lakes,0,16,0,16
2020-11-17,Hutt Valley,1,22,0,23
2020-11-17,Hawke's Bay,0,44,0,44
2020-11-17,Counties Manukau,1,214,1,216
2020-11-17,Capital and Coast,1,93,2,96
2020-11-17,Canterbury,0,155,12,167
2020-11-17,Bay of Plenty,0,48,0,48
2020-11-17,Managed Isolation & Quarantine,57,236,0,293
2020-11-17,Total,61,1919,25,2005
2020-11-18,Auckland,1,226,1,228
2020-11-18,Whanganui,0,9,0,9
2020-11-18,West Coast,0,4,1,5
2020-11-18,Waitemata,0,292,4,296
2020-11-18,Wairarapa,0,8,0,8
2020-11-18,Waikato,0,192,2,194
2020-11-18,Taranaki,0,16,0,16
2020-11-18,Tairawhiti,0,4,0,4
2020-11-18,Southern,0,214,2,216
2020-11-18,South Canterbury,0,17,0,17
2020-11-18,Northland,0,28,0,28
2020-11-18,Nelson Marlborough,0,49,0,49
2020-11-18,Mid Central,0,32,0,32
2020-11-18,Lakes,0,16,0,16
2020-11-18,Hutt Valley,1,22,0,23
2020-11-18,Hawke's Bay,0,44,0,44
2020-11-18,Counties Manukau,1,214,1,216
2020-11-18,Capital and Coast,1,93,2,96
2020-11-18,Canterbury,0,155,12,167
2020-11-18,Bay of Plenty,0,48,0,48
2020-11-18,Managed Isolation & Quarantine,60,236,0,296
2020-11-18,Total,64,1919,25,2008
2020-11-19,Auckland,1,226,1,228
2020-11-19,Whanganui,0,9,0,9
2020-11-19,West Coast,0,4,1,5
2020-11-19,Waitemata,0,292,4,296
2020-11-19,Wairarapa,0,8,0,8
2020-11-19,Waikato,0,192,2,194
2020-11-19,Taranaki,0,16,0,16
2020-11-19,Tairawhiti,0,4,0,4
2020-11-19,Southern,0,214,2,216
2020-11-19,South Canterbury,0,17,0,17
2020-11-19,Northland,0,28,0,28
2020-11-19,Nelson Marlborough,0,49,0,49
2020-11-19,Mid Central,0,32,0,32
2020-11-19,Lakes,0,16,0,16
2020-11-19,Hutt Valley,1,22,0,23
2020-11-19,Hawke's Bay,0,44,0,44
2020-11-19,Counties Manukau,1,214,1,216
2020-11-19,Capital and Coast,1,93,2,96
2020-11-19,Canterbury,0,155,12,167
2020-11-19,Bay of Plenty,0,48,0,48
2020-11-19,Managed Isolation & Quarantine,33,265,0,298
2020-11-19,Total,37,1948,25,2010
2020-11-20,Auckland,1,226,1,228
2020-11-20,Whanganui,0,9,0,9
2020-11-20,West Coast,0,4,1,5
2020-11-20,Waitemata,0,292,4,296
2020-11-20,Wairarapa,0,8,0,8
2020-11-20,Waikato,0,192,2,194
2020-11-20,Taranaki,0,16,0,16
2020-11-20,Tairawhiti,0,4,0,4
2020-11-20,Southern,0,214,2,216
2020-11-20,South Canterbury,0,17,0,17
2020-11-20,Northland,0,28,0,28
2020-11-20,Nelson Marlborough,0,49,0,49
2020-11-20,Mid Central,0,32,0,32
2020-11-20,Lakes,0,16,0,16
2020-11-20,Hutt Valley,1,22,0,23
2020-11-20,Hawke's Bay,0,44,0,44
2020-11-20,Counties Manukau,1,214,1,216
2020-11-20,Capital and Coast,1,93,2,96
2020-11-20,Canterbury,0,155,12,167
2020-11-20,Bay of Plenty,0,48,0,48
2020-11-20,Managed Isolation & Quarantine,36,265,0,301
2020-11-20,Total,40,1948,25,2013
2020-11-21,Auckland,1,226,1,228
2020-11-21,Whanganui,0,9,0,9
2020-11-21,West Coast,0,4,1,5
2020-11-21,Waitemata,0,292,4,296
2020-11-21,Wairarapa,0,8,0,8
2020-11-21,Waikato,0,192,2,194
2020-11-21,Taranaki,0,16,0,16
2020-11-21,Tairawhiti,0,4,0,4
2020-11-21,Southern,0,214,2,216
2020-11-21,South Canterbury,0,17,0,17
2020-11-21,Northland,0,28,0,28
2020-11-21,Nelson Marlborough,0,49,0,49
2020-11-21,Mid Central,0,32,0,32
2020-11-21,Lakes,0,16,0,16
2020-11-21,Hutt Valley,2,22,0,24
2020-11-21,Hawke's Bay,0,44,0,44
2020-11-21,Counties Manukau,1,214,1,216
2020-11-21,Capital and Coast,1,93,2,96
2020-11-21,Canterbury,0,155,12,167
2020-11-21,Bay of Plenty,0,48,0,48
2020-11-21,Managed Isolation & Quarantine,37,269,0,306
2020-11-21,Total,42,1952,25,2019
2020-11-22,Auckland,1,226,1,228
2020-11-22,Whanganui,0,9,0,9
2020-11-22,West Coast,0,4,1,5
2020-11-22,Waitemata,0,292,4,296
2020-11-22,Wairarapa,0,8,0,8
2020-11-22,Waikato,0,192,2,194
2020-11-22,Taranaki,0,16,0,16
2020-11-22,Tairawhiti,0,4,0,4
2020-11-22,Southern,0,214,2,216
2020-11-22,South Canterbury,0,17,0,17
2020-11-22,Northland,0,28,0,28
2020-11-22,Nelson Marlborough,0,49,0,49
2020-11-22,Mid Central,0,32,0,32
2020-11-22,Lakes,0,16,0,16
2020-11-22,Hutt Valley,2,22,0,24
2020-11-22,Hawke's Bay,0,44,0,44
2020-11-22,Counties Manukau,1,214,1,216
2020-11-22,Capital and Coast,1,93,2,96
2020-11-22,Canterbury,0,155,12,167
2020-11-22,Bay of Plenty,0,48,0,48
2020-11-22,Managed Isolation & Quarantine,45,270,0,315
2020-11-22,Total,50,1953,25,2028
2020-11-23,Auckland,1,226,1,228
2020-11-23,Whanganui,0,9,0,9
2020-11-23,West Coast,0,4,1,5
2020-11-23,Waitemata,0,292,4,296
2020-11-23,Wairarapa,0,8,0,8
2020-11-23,Waikato,0,192,2,194
2020-11-23,Taranaki,0,16,0,16
2020-11-23,Tairawhiti,0,4,0,4
2020-11-23,Southern,0,214,2,216
2020-11-23,South Canterbury,0,17,0,17
2020-11-23,Northland,0,28,0,28
2020-11-23,Nelson Marlborough,0,49,0,49
2020-11-23,Mid Central,0,32,0,32
2020-11-23,Lakes,0,16,0,16
2020-11-23,Hutt Valley,1,22,0,23
2020-11-23,Hawke's Bay,0,44,0,44
2020-11-23,Counties Manukau,1,214,1,216
2020-11-23,Capital and Coast,1,93,2,96
2020-11-23,Canterbury,0,155,12,167
2020-11-23,Bay of Plenty,0,48,0,48
2020-11-23,Managed Isolation & Quarantine,48,270,0,318
2020-11-23,Total,52,1953,25,2030
2020-11-24,Auckland,1,226,1,228
2020-11-24,Whanganui,0,9,0,9
2020-11-24,West Coast,0,4,1,5
2020-11-24,Waitemata,0,292,4,296
2020-11-24,Wairarapa,0,8,0,8
2020-11-24,Waikato,0,192,2,194
2020-11-24,Taranaki,0,16,0,16
2020-11-24,Tairawhiti,0,4,0,4
2020-11-24,Southern,0,214,2,216
2020-11-24,South Canterbury,0,17,0,17
2020-11-24,Northland,0,28,0,28
2020-11-24,Nelson Marlborough,0,49,0,49
2020-11-24,Mid Central,0,32,0,32
2020-11-24,Lakes,0,16,0,16
2020-11-24,Hutt Valley,1,22,0,23
2020-11-24,Hawke's Bay,0,44,0,44
2020-11-24,Counties Manukau,1,214,1,216
2020-11-24,Capital and Coast,1,93,2,96
2020-11-24,Canterbury,0,155,12,167
2020-11-24,Bay of Plenty,0,48,0,48
2020-11-24,Managed Isolation & Quarantine,49,270,0,319
2020-11-24,Total,53,1953,25,2031
2020-11-25,Auckland,0,227,1,228
2020-11-25,Whanganui,0,9,0,9
2020-11-25,West Coast,0,4,1,5
2020-11-25,Waitemata,0,292,4,296
2020-11-25,Wairarapa,0,8,0,8
2020-11-25,Waikato,0,192,2,194
2020-11-25,Taranaki,0,16,0,16
2020-11-25,Tairawhiti,0,4,0,4
2020-11-25,Southern,0,214,2,216
2020-11-25,South Canterbury,0,17,0,17
2020-11-25,Northland,0,28,0,28
2020-11-25,Nelson Marlborough,0,49,0,49
2020-11-25,Mid Central,0,32,0,32
2020-11-25,Lakes,0,16,0,16
2020-11-25,Hutt Valley,2,22,0,24
2020-11-25,Hawke's Bay,0,44,0,44
2020-11-25,Counties Manukau,1,214,1,216
2020-11-25,Capital and Coast,1,93,2,96
2020-11-25,Canterbury,0,155,12,167
2020-11-25,Bay of Plenty,0,48,0,48
2020-11-25,Managed Isolation & Quarantine,55,271,0,326
2020-11-25,Total,59,1955,25,2039
2020-11-26,Auckland,0,227,1,228
2020-11-26,Whanganui,0,9,0,9
2020-11-26,West Coast,0,4,1,5
2020-11-26,Waitemata,0,292,4,296
2020-11-26,Wairarapa,0,8,0,8
2020-11-26,Waikato,0,192,2,194
2020-11-26,Taranaki,0,16,0,16
2020-11-26,Tairawhiti,0,4,0,4
2020-11-26,Southern,0,214,2,216
2020-11-26,South Canterbury,0,17,0,17
2020-11-26,Northland,0,28,0,28
2020-11-26,Nelson Marlborough,0,49,0,49
2020-11-26,Mid Central,0,32,0,32
2020-11-26,Lakes,0,16,0,16
2020-11-26,Hutt Valley,2,22,0,24
2020-11-26,Hawke's Bay,0,44,0,44
2020-11-26,Counties Manukau,1,214,1,216
2020-11-26,Capital and Coast,1,93,2,96
2020-11-26,Canterbury,0,155,12,167
2020-11-26,Bay of Plenty,0,48,0,48
2020-11-26,Managed Isolation & Quarantine,56,271,0,327
2020-11-26,Total,60,1955,25,2040
2020-11-27,Auckland,0,227,1,228
2020-11-27,Whanganui,0,9,0,9
2020-11-27,West Coast,0,4,1,5
2020-11-27,Waitemata,0,292,4,296
2020-11-27,Wairarapa,0,8,0,8
2020-11-27,Waikato,0,192,2,194
2020-11-27,Taranaki,0,16,0,16
2020-11-27,Tairawhiti,0,4,0,4
2020-11-27,Southern,0,214,2,216
2020-11-27,South Canterbury,0,17,0,17
2020-11-27,Northland,0,28,0,28
2020-11-27,Nelson Marlborough,0,49,0,49
2020-11-27,Mid Central,0,32,0,32
2020-11-27,Lakes,0,16,0,16
2020-11-27,Hutt Valley,2,22,0,24
2020-11-27,Hawke's Bay,0,44,0,44
2020-11-27,Counties Manukau,0,215,1,216
2020-11-27,Capital and Coast,1,93,2,96
2020-11-27,Canterbury,0,155,12,167
2020-11-27,Bay of Plenty,0,48,0,48
2020-11-27,Managed Isolation & Quarantine,63,271,0,334
2020-11-27,Total,66,1956,25,2047
2020-11-28,Auckland,0,227,1,228
2020-11-28,Whanganui,0,9,0,9
2020-11-28,West Coast,0,4,1,5
2020-11-28,Waitemata,0,292,4,296
2020-11-28,Wairarapa,0,8,0,8
2020-11-28,Waikato,0,192,2,194
2020-11-28,Taranaki,0,16,0,16
2020-11-28,Tairawhiti,0,4,0,4
2020-11-28,Southern,0,214,2,216
2020-11-28,South Canterbury,0,17,0,17
2020-11-28,Northland,0,28,0,28
2020-11-28,Nelson Marlborough,0,49,0,49
2020-11-28,Mid Central,0,32,0,32
2020-11-28,Lakes,0,16,0,16
2020-11-28,Hutt Valley,2,22,0,24
2020-11-28,Hawke's Bay,0,44,0,44
2020-11-28,Counties Manukau,0,215,1,216
2020-11-28,Capital and Coast,1,93,2,96
2020-11-28,Canterbury,0,155,12,167
2020-11-28,Bay of Plenty,0,48,0,48
2020-11-28,Managed Isolation & Quarantine,66,271,0,337
2020-11-28,Total,69,1956,25,2050
2020-11-30,Auckland,0,227,1,228
2020-11-30,Whanganui,0,9,0,9
2020-11-30,West Coast,0,4,1,5
2020-11-30,Waitemata,0,292,4,296
2020-11-30,Wairarapa,0,8,0,8
2020-11-30,Waikato,0,192,2,194
2020-11-30,Taranaki,0,16,0,16
2020-11-30,Tairawhiti,0,4,0,4
2020-11-30,Southern,0,214,2,216
2020-11-30,South Canterbury,0,17,0,17
2020-11-30,Northland,0,28,0,28
2020-11-30,Nelson Marlborough,0,49,0,49
2020-11-30,Mid Central,0,32,0,32
2020-11-30,Lakes,0,16,0,16
2020-11-30,Hutt Valley,2,22,0,24
2020-11-30,Hawke's Bay,0,44,0,44
2020-11-30,Counties Manukau,0,215,1,216
2020-11-30,Capital and Coast,1,93,2,96
2020-11-30,Canterbury,0,155,12,167
2020-11-30,Bay of Plenty,0,48,0,48
2020-11-30,Managed Isolation & Quarantine,69,274,0,343
2020-11-30,Total,72,1959,25,2056
2020-12-01,Auckland,0,227,1,228
2020-12-01,Whanganui,0,9,0,9
2020-12-01,West Coast,0,4,1,5
2020-12-01,Waitemata,0,292,4,296
2020-12-01,Wairarapa,0,8,0,8
2020-12-01,Waikato,0,192,2,194
2020-12-01,Taranaki,0,16,0,16
2020-12-01,Tairawhiti,0,4,0,4
2020-12-01,Southern,0,214,2,216
2020-12-01,South Canterbury,0,17,0,17
2020-12-01,Northland,0,28,0,28
2020-12-01,Nelson Marlborough,0,49,0,49
2020-12-01,Mid Central,0,32,0,32
2020-12-01,Lakes,0,16,0,16
2020-12-01,Hutt Valley,2,22,0,24
2020-12-01,Hawke's Bay,0,44,0,44
2020-12-01,Counties Manukau,0,215,1,216
2020-12-01,Capital and Coast,1,93,2,96
2020-12-01,Canterbury,0,155,12,167
2020-12-01,Bay of Plenty,0,48,0,48
2020-12-01,Managed Isolation & Quarantine,69,277,0,346
2020-12-01,Total,72,1962,25,2059
2020-12-02,Auckland,0,227,1,228
2020-12-02,Whanganui,0,9,0,9
2020-12-02,West Coast,0,4,1,5
2020-12-02,Waitemata,0,292,4,296
2020-12-02,Wairarapa,0,8,0,8
2020-12-02,Waikato,0,192,2,194
2020-12-02,Taranaki,0,16,0,16
2020-12-02,Tairawhiti,0,4,0,4
2020-12-02,Southern,0,214,2,216
2020-12-02,South Canterbury,0,17,0,17
2020-12-02,Northland,0,28,0,28
2020-12-02,Nelson Marlborough,0,49,0,49
2020-12-02,Mid Central,0,32,0,32
2020-12-02,Lakes,0,16,0,16
2020-12-02,Hutt Valley,2,22,0,24
2020-12-02,Hawke's Bay,0,44,0,44
2020-12-02,Counties Manukau,0,215,1,216
2020-12-02,Capital and Coast,1,93,2,96
2020-12-02,Canterbury,0,155,12,167
2020-12-02,Bay of Plenty,0,48,0,48
2020-12-02,Managed Isolation & Quarantine,69,278,0,347
2020-12-02,Total,72,1963,25,2060
2020-12-03,Auckland,0,227,1,228
2020-12-03,Whanganui,0,9,0,9
2020-12-03,West Coast,0,4,1,5
2020-12-03,Waitemata,0,292,4,296
2020-12-03,Wairarapa,0,8,0,8
2020-12-03,Waikato,0,192,2,194
2020-12-03,Taranaki,0,16,0,16
2020-12-03,Tairawhiti,0,4,0,4
2020-12-03,Southern,0,214,2,216
2020-12-03,South Canterbury,0,17,0,17
2020-12-03,Northland,0,28,0,28
2020-12-03,Nelson Marlborough,0,49,0,49
2020-12-03,Mid Central,0,32,0,32
2020-12-03,Lakes,0,16,0,16
2020-12-03,Hutt Valley,2,22,0,24
2020-12-03,Hawke's Bay,0,44,0,44
2020-12-03,Counties Manukau,0,215,1,216
2020-12-03,Capital and Coast,1,93,2,96
2020-12-03,Canterbury,0,155,12,167
2020-12-03,Bay of Plenty,0,48,0,48
2020-12-03,Managed Isolation & Quarantine,67,289,0,356
2020-12-03,Total,70,1974,25,2069
2020-12-04,Auckland,0,227,1,228
2020-12-04,Whanganui,0,9,0,9
2020-12-04,West Coast,0,4,1,5
2020-12-04,Waitemata,0,292,4,296
2020-12-04,Wairarapa,0,8,0,8
2020-12-04,Waikato,0,192,2,194
2020-12-04,Taranaki,0,16,0,16
2020-12-04,Tairawhiti,0,4,0,4
2020-12-04,Southern,0,214,2,216
2020-12-04,South Canterbury,0,17,0,17
2020-12-04,Northland,0,28,0,28
2020-12-04,Nelson Marlborough,0,49,0,49
2020-12-04,Mid Central,0,32,0,32
2020-12-04,Lakes,0,16,0,16
2020-12-04,Hutt Valley,2,22,0,24
2020-12-04,Hawke's Bay,0,44,0,44
2020-12-04,Counties Manukau,0,215,1,216
2020-12-04,Capital and Coast,0,94,2,96
2020-12-04,Canterbury,0,155,12,167
2020-12-04,Bay of Plenty,0,48,0,48
2020-12-04,Managed Isolation & Quarantine,59,297,0,356
2020-12-04,Total,61,1983,25,2069
2020-12-05,Auckland,0,227,1,228
2020-12-05,Whanganui,0,9,0,9
2020-12-05,West Coast,0,4,1,5
2020-12-05,Waitemata,0,292,4,296
2020-12-05,Wairarapa,0,8,0,8
2020-12-05,Waikato,0,192,2,194
2020-12-05,Taranaki,0,16,0,16
2020-12-05,Tairawhiti,0,4,0,4
2020-12-05,Southern,0,214,2,216
2020-12-05,South Canterbury,0,17,0,17
2020-12-05,Northland,0,28,0,28
2020-12-05,Nelson Marlborough,0,49,0,49
2020-12-05,Mid Central,0,32,0,32
2020-12-05,Lakes,0,16,0,16
2020-12-05,Hutt Valley,1,23,0,24
2020-12-05,Hawke's Bay,0,44,0,44
2020-12-05,Counties Manukau,0,215,1,216
2020-12-05,Capital and Coast,0,94,2,96
2020-12-05,Canterbury,0,155,12,167
2020-12-05,Bay of Plenty,0,48,0,48
2020-12-05,Managed Isolation & Quarantine,58,307,0,365
2020-12-05,Total,59,1994,25,2078
2020-12-06,Auckland,0,227,1,228
2020-12-06,Whanganui,0,9,0,9
2020-12-06,West Coast,0,4,1,5
2020-12-06,Waitemata,0,292,4,296
2020-12-06,Wairarapa,0,8,0,8
2020-12-06,Waikato,0,192,2,194
2020-12-06,Taranaki,0,16,0,16
2020-12-06,Tairawhiti,0,4,0,4
2020-12-06,Southern,0,214,2,216
2020-12-06,South Canterbury,0,17,0,17
2020-12-06,Northland,0,28,0,28
2020-12-06,Nelson Marlborough,0,49,0,49
2020-12-06,Mid Central,0,32,0,32
2020-12-06,Lakes,0,16,0,16
2020-12-06,Hutt Valley,1,23,0,24
2020-12-06,Hawke's Bay,0,44,0,44
2020-12-06,Counties Manukau,0,215,1,216
2020-12-06,Capital and Coast,0,94,2,96
2020-12-06,Canterbury,0,155,12,167
2020-12-06,Bay of Plenty,0,48,0,48
2020-12-06,Managed Isolation & Quarantine,55,310,0,365
2020-12-06,Total,56,1997,25,2078
2020-12-07,Auckland,0,227,1,228
2020-12-07,Whanganui,0,9,0,9
2020-12-07,West Coast,0,4,1,5
2020-12-07,Waitemata,0,292,4,296
2020-12-07,Wairarapa,0,8,0,8
2020-12-07,Waikato,0,192,2,194
2020-12-07,Taranaki,0,16,0,16
2020-12-07,Tairawhiti,0,4,0,4
2020-12-07,Southern,0,214,2,216
2020-12-07,South Canterbury,0,17,0,17
2020-12-07,Northland,0,28,0,28
2020-12-07,Nelson Marlborough,0,49,0,49
2020-12-07,Mid Central,0,32,0,32
2020-12-07,Lakes,0,16,0,16
2020-12-07,Hutt Valley,1,23,0,24
2020-12-07,Hawke's Bay,0,44,0,44
2020-12-07,Counties Manukau,0,215,1,216
2020-12-07,Capital and Coast,0,94,2,96
2020-12-07,Canterbury,0,155,12,167
2020-12-07,Bay of Plenty,0,48,0,48
2020-12-07,Managed Isolation & Quarantine,55,311,0,366
2020-12-07,Total,56,1998,25,2079
2020-12-08,Auckland,0,227,1,228
2020-12-08,Whanganui,0,9,0,9
2020-12-08,West Coast,0,4,1,5
2020-12-08,Waitemata,0,292,4,296
2020-12-08,Wairarapa,0,8,0,8
2020-12-08,Waikato,0,192,2,194
2020-12-08,Taranaki,0,16,0,16
2020-12-08,Tairawhiti,0,4,0,4
2020-12-08,Southern,0,214,2,216
2020-12-08,South Canterbury,0,17,0,17
2020-12-08,Northland,0,28,0,28
2020-12-08,Nelson Marlborough,0,49,0,49
2020-12-08,Mid Central,0,32,0,32
2020-12-08,Lakes,0,16,0,16
2020-12-08,Hutt Valley,0,24,0,24
2020-12-08,Hawke's Bay,0,44,0,44
2020-12-08,Counties Manukau,0,215,1,216
2020-12-08,Capital and Coast,0,94,2,96
2020-12-08,Canterbury,0,155,12,167
2020-12-08,Bay of Plenty,0,48,0,48
2020-12-08,Managed Isolation & Quarantine,54,318,0,372
2020-12-08,Total,54,2006,25,2085
2020-12-09,Auckland,0,227,1,228
2020-12-09,Whanganui,0,9,0,9
2020-12-09,West Coast,0,4,1,5
2020-12-09,Waitemata,0,292,4,296
2020-12-09,Wairarapa,0,8,0,8
2020-12-09,Waikato,0,192,2,194
2020-12-09,Taranaki,0,16,0,16
2020-12-09,Tairawhiti,0,4,0,4
2020-12-09,Southern,0,214,2,216
2020-12-09,South Canterbury,0,17,0,17
2020-12-09,Northland,0,28,0,28
2020-12-09,Nelson Marlborough,0,49,0,49
2020-12-09,Mid Central,0,32,0,32
2020-12-09,Lakes,0,16,0,16
2020-12-09,Hutt Valley,0,24,0,24
2020-12-09,Hawke's Bay,0,44,0,44
2020-12-09,Counties Manukau,0,215,1,216
2020-12-09,Capital and Coast,0,94,2,96
2020-12-09,Canterbury,0,155,12,167
2020-12-09,Bay of Plenty,0,48,0,48
2020-12-09,Managed Isolation & Quarantine,55,320,0,375
2020-12-09,Total,55,2008,25,2088
2020-12-11,Auckland,0,227,1,228
2020-12-11,Whanganui,0,9,0,9
2020-12-11,West Coast,0,4,1,5
2020-12-11,Waitemata,0,292,4,296
2020-12-11,Wairarapa,0,8,0,8
2020-12-11,Waikato,0,192,2,194
2020-12-11,Taranaki,0,16,0,16
2020-12-11,Tairawhiti,0,4,0,4
2020-12-11,Southern,0,214,2,216
2020-12-11,South Canterbury,0,17,0,17
2020-12-11,Northland,0,28,0,28
2020-12-11,Nelson Marlborough,0,49,0,49
2020-12-11,Mid Central,0,32,0,32
2020-12-11,Lakes,0,16,0,16
2020-12-11,Hutt Valley,0,24,0,24
2020-12-11,Hawke's Bay,0,44,0,44
2020-12-11,Counties Manukau,0,215,1,216
2020-12-11,Capital and Coast,0,94,2,96
2020-12-11,Canterbury,0,155,12,167
2020-12-11,Bay of Plenty,0,48,0,48
2020-12-11,Managed Isolation & Quarantine,57,322,0,379
2020-12-11,Total,57,2010,25,2092
2020-12-13,Auckland,0,227,1,228
2020-12-13,Whanganui,0,9,0,9
2020-12-13,West Coast,0,4,1,5
2020-12-13,Waitemata,0,292,4,296
2020-12-13,Wairarapa,0,8,0,8
2020-12-13,Waikato,0,192,2,194
2020-12-13,Taranaki,0,16,0,16
2020-12-13,Tairawhiti,0,4,0,4
2020-12-13,Southern,0,214,2,216
2020-12-13,South Canterbury,0,17,0,17
2020-12-13,Northland,0,28,0,28
2020-12-13,Nelson Marlborough,0,49,0,49
2020-12-13,Mid Central,0,32,0,32
2020-12-13,Lakes,0,16,0,16
2020-12-13,Hutt Valley,0,24,0,24
2020-12-13,Hawke's Bay,0,44,0,44
2020-12-13,Counties Manukau,0,215,1,216
2020-12-13,Capital and Coast,0,94,2,96
2020-12-13,Canterbury,0,155,12,167
2020-12-13,Bay of Plenty,0,48,0,48
2020-12-13,Managed Isolation & Quarantine,56,327,0,383
2020-12-13,Total,56,2015,25,2096
2020-12-14,Auckland,0,227,1,228
2020-12-14,Whanganui,0,9,0,9
2020-12-14,West Coast,0,4,1,5
2020-12-14,Waitemata,0,292,4,296
2020-12-14,Wairarapa,0,8,0,8
2020-12-14,Waikato,0,192,2,194
2020-12-14,Taranaki,0,16,0,16
2020-12-14,Tairawhiti,0,4,0,4
2020-12-14,Southern,0,214,2,216
2020-12-14,South Canterbury,0,17,0,17
2020-12-14,Northland,0,28,0,28
2020-12-14,Nelson Marlborough,0,49,0,49
2020-12-14,Mid Central,0,32,0,32
2020-12-14,Lakes,0,16,0,16
2020-12-14,Hutt Valley,0,24,0,24
2020-12-14,Hawke's Bay,0,44,0,44
2020-12-14,Counties Manukau,0,215,1,216
2020-12-14,Capital and Coast,0,94,2,96
2020-12-14,Canterbury,0,155,12,167
2020-12-14,Bay of Plenty,0,48,0,48
2020-12-14,Managed Isolation & Quarantine,56,327,0,383
2020-12-14,Total,56,2015,25,2096
2020-12-16,Auckland,0,227,1,228
2020-12-16,Whanganui,0,9,0,9
2020-12-16,West Coast,0,4,1,5
2020-12-16,Waitemata,0,292,4,296
2020-12-16,Wairarapa,0,8,0,8
2020-12-16,Waikato,0,192,2,194
2020-12-16,Taranaki,0,16,0,16
2020-12-16,Tairawhiti,0,4,0,4
2020-12-16,Southern,0,214,2,216
2020-12-16,South Canterbury,0,17,0,17
2020-12-16,Northland,0,28,0,28
2020-12-16,Nelson Marlborough,0,49,0,49
2020-12-16,Mid Central,0,32,0,32
2020-12-16,Lakes,0,16,0,16
2020-12-16,Hutt Valley,0,24,0,24
2020-12-16,Hawke's Bay,0,44,0,44
2020-12-16,Counties Manukau,0,215,1,216
2020-12-16,Capital and Coast,0,94,2,96
2020-12-16,Canterbury,0,155,12,167
2020-12-16,Bay of Plenty,0,48,0,48
2020-12-16,Managed Isolation & Quarantine,43,344,0,387
2020-12-16,Total,43,2032,25,2100
2020-12-18,Auckland,0,227,1,228
2020-12-18,Whanganui,0,9,0,9
2020-12-18,West Coast,0,4,1,5
2020-12-18,Waitemata,0,292,4,296
2020-12-18,Wairarapa,0,8,0,8
2020-12-18,Waikato,0,192,2,194
2020-12-18,Taranaki,0,16,0,16
2020-12-18,Tairawhiti,0,4,0,4
2020-12-18,Southern,0,214,2,216
2020-12-18,South Canterbury,0,17,0,17
2020-12-18,Northland,0,28,0,28
2020-12-18,Nelson Marlborough,0,49,0,49
2020-12-18,Mid Central,0,32,0,32
2020-12-18,Lakes,0,16,0,16
2020-12-18,Hutt Valley,0,24,0,24
2020-12-18,Hawke's Bay,0,44,0,44
2020-12-18,Counties Manukau,0,215,1,216
2020-12-18,Capital and Coast,0,94,2,96
2020-12-18,Canterbury,0,155,12,167
2020-12-18,Bay of Plenty,0,48,0,48
2020-12-18,Managed Isolation & Quarantine,51,346,0,397
2020-12-18,Total,51,2034,25,2110
2020-12-20,Auckland,0,227,1,228
2020-12-20,Whanganui,0,9,0,9
2020-12-20,West Coast,0,4,1,5
2020-12-20,Waitemata,0,292,4,296
2020-12-20,Wairarapa,0,8,0,8
2020-12-20,Waikato,0,192,2,194
2020-12-20,Taranaki,0,16,0,16
2020-12-20,Tairawhiti,0,4,0,4
2020-12-20,Southern,0,214,2,216
2020-12-20,South Canterbury,0,17,0,17
2020-12-20,Northland,0,28,0,28
2020-12-20,Nelson Marlborough,0,49,0,49
2020-12-20,Mid Central,0,32,0,32
2020-12-20,Lakes,0,16,0,16
2020-12-20,Hutt Valley,0,24,0,24
2020-12-20,Hawke's Bay,0,44,0,44
2020-12-20,Counties Manukau,0,215,1,216
2020-12-20,Capital and Coast,0,94,2,96
2020-12-20,Canterbury,0,155,12,167
2020-12-20,Bay of Plenty,0,48,0,48
2020-12-20,Managed Isolation & Quarantine,55,348,0,403
2020-12-20,Total,55,2036,25,2116
2020-12-21,Auckland,0,227,1,228
2020-12-21,Whanganui,0,9,0,9
2020-12-21,West Coast,0,4,1,5
2020-12-21,Waitemata,0,292,4,296
2020-12-21,Wairarapa,0,8,0,8
2020-12-21,Waikato,0,192,2,194
2020-12-21,Taranaki,0,16,0,16
2020-12-21,Tairawhiti,0,4,0,4
2020-12-21,Southern,0,214,2,216
2020-12-21,South Canterbury,0,17,0,17
2020-12-21,Northland,0,28,0,28
2020-12-21,Nelson Marlborough,0,49,0,49
2020-12-21,Mid Central,0,32,0,32
2020-12-21,Lakes,0,16,0,16
2020-12-21,Hutt Valley,0,24,0,24
2020-12-21,Hawke's Bay,0,44,0,44
2020-12-21,Counties Manukau,0,215,1,216
2020-12-21,Capital and Coast,0,94,2,96
2020-12-21,Canterbury,0,155,12,167
2020-12-21,Bay of Plenty,0,48,0,48
2020-12-21,Managed Isolation & Quarantine,59,349,0,408
2020-12-21,Total,59,2037,25,2121
2020-12-23,Auckland,0,227,1,228
2020-12-23,Whanganui,0,9,0,9
2020-12-23,West Coast,0,4,1,5
2020-12-23,Waitemata,0,292,4,296
2020-12-23,Wairarapa,0,8,0,8
2020-12-23,Waikato,0,192,2,194
2020-12-23,Taranaki,0,16,0,16
2020-12-23,Tairawhiti,0,4,0,4
2020-12-23,Southern,0,214,2,216
2020-12-23,South Canterbury,0,17,0,17
2020-12-23,Northland,0,28,0,28
2020-12-23,Nelson Marlborough,0,49,0,49
2020-12-23,Mid Central,0,32,0,32
2020-12-23,Lakes,0,16,0,16
2020-12-23,Hutt Valley,0,24,0,24
2020-12-23,Hawke's Bay,0,44,0,44
2020-12-23,Counties Manukau,0,215,1,216
2020-12-23,Capital and Coast,0,94,2,96
2020-12-23,Canterbury,0,155,12,167
2020-12-23,Bay of Plenty,0,48,0,48
2020-12-23,Managed Isolation & Quarantine,49,366,0,415
2020-12-23,Total,49,2054,25,2128
2020-12-27,Auckland,0,227,1,228
2020-12-27,Whanganui,0,9,0,9
2020-12-27,West Coast,0,4,1,5
2020-12-27,Waitemata,0,292,4,296
2020-12-27,Wairarapa,0,8,0,8
2020-12-27,Waikato,0,192,2,194
2020-12-27,Taranaki,0,16,0,16
2020-12-27,Tairawhiti,0,4,0,4
2020-12-27,Southern,0,214,2,216
2020-12-27,South Canterbury,0,17,0,17
2020-12-27,Northland,0,28,0,28
2020-12-27,Nelson Marlborough,0,49,0,49
2020-12-27,Mid Central,0,32,0,32
2020-12-27,Lakes,0,16,0,16
2020-12-27,Hutt Valley,0,24,0,24
2020-12-27,Hawke's Bay,0,44,0,44
2020-12-27,Counties Manukau,0,215,1,216
2020-12-27,Capital and Coast,0,94,2,96
2020-12-27,Canterbury,0,155,12,167
2020-12-27,Bay of Plenty,0,48,0,48
2020-12-27,Managed Isolation & Quarantine,50,380,0,430
2020-12-27,Total,50,2069,25,2144
2020-12-29,Auckland,0,227,1,228
2020-12-29,Whanganui,0,9,0,9
2020-12-29,West Coast,0,4,1,5
2020-12-29,Waitemata,0,292,4,296
2020-12-29,Wairarapa,0,8,0,8
2020-12-29,Waikato,0,192,2,194
2020-12-29,Taranaki,0,16,0,16
2020-12-29,Tairawhiti,0,4,0,4
2020-12-29,Southern,0,214,2,216
2020-12-29,South Canterbury,0,17,0,17
2020-12-29,Northland,0,28,0,28
2020-12-29,Nelson Marlborough,0,49,0,49
2020-12-29,Mid Central,0,32,0,32
2020-12-29,Lakes,0,16,0,16
2020-12-29,Hutt Valley,0,24,0,24
2020-12-29,Hawke's Bay,0,44,0,44
2020-12-29,Counties Manukau,0,215,1,216
2020-12-29,Capital and Coast,0,94,2,96
2020-12-29,Canterbury,0,156,12,168
2020-12-29,Bay of Plenty,0,48,0,48
2020-12-29,Managed Isolation & Quarantine,49,388,0,437
2020-12-29,Total,49,2077,25,2151
2020-12-31,Auckland,0,226,1,227
2020-12-31,Whanganui,0,9,0,9
2020-12-31,West Coast,0,4,1,5
2020-12-31,Waitemata,0,293,4,297
2020-12-31,Wairarapa,0,8,0,8
2020-12-31,Waikato,0,192,2,194
2020-12-31,Taranaki,0,16,0,16
2020-12-31,Tairawhiti,0,4,0,4
2020-12-31,Southern,0,214,2,216
2020-12-31,South Canterbury,0,17,0,17
2020-12-31,Northland,0,28,0,28
2020-12-31,Nelson Marlborough,0,49,0,49
2020-12-31,Mid Central,0,32,0,32
2020-12-31,Lakes,0,16,0,16
2020-12-31,Hutt Valley,0,24,0,24
2020-12-31,Hawke's Bay,0,44,0,44
2020-12-31,Counties Manukau,0,215,1,216
2020-12-31,Capital and Coast,0,94,2,96
2020-12-31,Canterbury,0,156,12,168
2020-12-31,Bay of Plenty,0,48,0,48
2020-12-31,Managed Isolation & Quarantine,55,393,0,448
2020-12-31,Total,55,2082,25,2162
2021-01-03,Auckland,0,226,1,227
2021-01-03,Whanganui,0,9,0,9
2021-01-03,West Coast,0,4,1,5
2021-01-03,Waitemata,0,293,4,297
2021-01-03,Wairarapa,0,8,0,8
2021-01-03,Waikato,0,192,2,194
2021-01-03,Taranaki,0,16,0,16
2021-01-03,Tairawhiti,0,4,0,4
2021-01-03,Southern,0,214,2,216
2021-01-03,South Canterbury,0,17,0,17
2021-01-03,Northland,0,28,0,28
2021-01-03,Nelson Marlborough,0,49,0,49
2021-01-03,Mid Central,0,32,0,32
2021-01-03,Lakes,0,16,0,16
2021-01-03,Hutt Valley,0,24,0,24
2021-01-03,Hawke's Bay,0,44,0,44
2021-01-03,Counties Manukau,0,215,1,216
2021-01-03,Capital and Coast,0,94,2,96
2021-01-03,Canterbury,0,156,12,168
2021-01-03,Bay of Plenty,0,48,0,48
2021-01-03,Managed Isolation & Quarantine,72,395,0,467
2021-01-03,Total,72,2084,25,2181
2021-01-05,Auckland,0,226,1,227
2021-01-05,Whanganui,0,9,0,9
2021-01-05,West Coast,0,4,1,5
2021-01-05,Waitemata,0,293,4,297
2021-01-05,Wairarapa,0,8,0,8
2021-01-05,Waikato,0,192,2,194
2021-01-05,Taranaki,0,16,0,16
2021-01-05,Tairawhiti,0,4,0,4
2021-01-05,Southern,0,214,2,216
2021-01-05,South Canterbury,0,17,0,17
2021-01-05,Northland,0,28,0,28
2021-01-05,Nelson Marlborough,0,49,0,49
2021-01-05,Mid Central,0,32,0,32
2021-01-05,Lakes,0,16,0,16
2021-01-05,Hutt Valley,0,24,0,24
2021-01-05,Hawke's Bay,0,44,0,44
2021-01-05,Counties Manukau,0,215,1,216
2021-01-05,Capital and Coast,0,94,2,96
2021-01-05,Canterbury,0,156,12,168
2021-01-05,Bay of Plenty,0,48,0,48
2021-01-05,Managed Isolation & Quarantine,61,411,0,472
2021-01-05,Total,61,2100,25,2186
2021-01-07,Auckland,0,226,1,227
2021-01-07,Whanganui,0,9,0,9
2021-01-07,West Coast,0,4,1,5
2021-01-07,Waitemata,0,293,4,297
2021-01-07,Wairarapa,0,8,0,8
2021-01-07,Waikato,0,192,2,194
2021-01-07,Taranaki,0,16,0,16
2021-01-07,Tairawhiti,0,4,0,4
2021-01-07,Southern,0,214,2,216
2021-01-07,South Canterbury,0,17,0,17
2021-01-07,Northland,0,28,0,28
2021-01-07,Nelson Marlborough,0,49,0,49
2021-01-07,Mid Central,0,32,0,32
2021-01-07,Lakes,0,16,0,16
2021-01-07,Hutt Valley,0,24,0,24
2021-01-07,Hawke's Bay,0,44,0,44
2021-01-07,Counties Manukau,0,215,1,216
2021-01-07,Capital and Coast,0,94,2,96
2021-01-07,Canterbury,0,156,12,168
2021-01-07,Bay of Plenty,0,48,0,48
2021-01-07,Managed Isolation & Quarantine,62,412,0,474
2021-01-07,Total,62,2101,25,2188
2021-01-10,Auckland,0,226,1,227
2021-01-10,Whanganui,0,9,0,9
2021-01-10,West Coast,0,4,1,5
2021-01-10,Waitemata,0,293,4,297
2021-01-10,Wairarapa,0,8,0,8
2021-01-10,Waikato,0,192,2,194
2021-01-10,Taranaki,0,16,0,16
2021-01-10,Tairawhiti,0,4,0,4
2021-01-10,Southern,0,214,2,216
2021-01-10,South Canterbury,0,17,0,17
2021-01-10,Northland,0,28,0,28
2021-01-10,Nelson Marlborough,0,49,0,49
2021-01-10,Mid Central,0,32,0,32
2021-01-10,Lakes,0,16,0,16
2021-01-10,Hutt Valley,0,24,0,24
2021-01-10,Hawke's Bay,0,44,0,44
2021-01-10,Counties Manukau,0,215,1,216
2021-01-10,Capital and Coast,0,94,2,96
2021-01-10,Canterbury,0,156,12,168
2021-01-10,Bay of Plenty,0,48,0,48
2021-01-10,Managed Isolation & Quarantine,75,430,0,505
2021-01-10,Total,75,2119,25,2219
2021-01-11,Auckland,0,226,1,227
2021-01-11,Whanganui,0,9,0,9
2021-01-11,West Coast,0,4,1,5
2021-01-11,Waitemata,0,293,4,297
2021-01-11,Wairarapa,0,8,0,8
2021-01-11,Waikato,0,192,2,194
2021-01-11,Taranaki,0,16,0,16
2021-01-11,Tairawhiti,0,4,0,4
2021-01-11,Southern,0,214,2,216
2021-01-11,South Canterbury,0,17,0,17
2021-01-11,Northland,0,28,0,28
2021-01-11,Nelson Marlborough,0,49,0,49
2021-01-11,Mid Central,0,32,0,32
2021-01-11,Lakes,0,16,0,16
2021-01-11,Hutt Valley,0,24,0,24
2021-01-11,Hawke's Bay,0,44,0,44
2021-01-11,Counties Manukau,0,215,1,216
2021-01-11,Capital and Coast,0,94,2,96
2021-01-11,Canterbury,0,156,12,168
2021-01-11,Bay of Plenty,0,48,0,48
2021-01-11,Managed Isolation & Quarantine,77,431,0,508
2021-01-11,Total,77,2120,25,2222
2021-01-13,Auckland,0,226,1,227
2021-01-13,Whanganui,0,9,0,9
2021-01-13,West Coast,0,4,1,5
2021-01-13,Waitemata,0,293,4,297
2021-01-13,Wairarapa,0,8,0,8
2021-01-13,Waikato,0,192,2,194
2021-01-13,Taranaki,0,16,0,16
2021-01-13,Tairawhiti,0,4,0,4
2021-01-13,Southern,0,214,2,216
2021-01-13,South Canterbury,0,17,0,17
2021-01-13,Northland,0,28,0,28
2021-01-13,Nelson Marlborough,0,49,0,49
2021-01-13,Mid Central,0,32,0,32
2021-01-13,Lakes,0,16,0,16
2021-01-13,Hutt Valley,0,24,0,24
2021-01-13,Hawke's Bay,0,44,0,44
2021-01-13,Counties Manukau,0,215,1,216
2021-01-13,Capital and Coast,0,94,2,96
2021-01-13,Canterbury,0,156,12,168
2021-01-13,Bay of Plenty,0,48,0,48
2021-01-13,Managed Isolation & Quarantine,62,452,0,514
2021-01-13,Total,62,2141,25,2228
2021-01-15,Auckland,0,226,1,227
2021-01-15,Whanganui,0,9,0,9
2021-01-15,West Coast,0,4,1,5
2021-01-15,Waitemata,0,293,4,297
2021-01-15,Wairarapa,0,8,0,8
2021-01-15,Waikato,0,192,2,194
2021-01-15,Taranaki,0,16,0,16
2021-01-15,Tairawhiti,0,4,0,4
2021-01-15,Southern,0,214,2,216
2021-01-15,South Canterbury,0,17,0,17
2021-01-15,Northland,0,28,0,28
2021-01-15,Nelson Marlborough,0,49,0,49
2021-01-15,Mid Central,0,32,0,32
2021-01-15,Lakes,0,16,0,16
2021-01-15,Hutt Valley,0,24,0,24
2021-01-15,Hawke's Bay,0,44,0,44
2021-01-15,Counties Manukau,0,215,1,216
2021-01-15,Capital and Coast,0,94,2,96
2021-01-15,Canterbury,0,156,12,168
2021-01-15,Bay of Plenty,0,48,0,48
2021-01-15,Managed Isolation & Quarantine,76,456,0,532
2021-01-15,Total,76,2145,25,2246
2021-01-17,Auckland,0,226,1,227
2021-01-17,Whanganui,0,9,0,9
2021-01-17,West Coast,0,4,1,5
2021-01-17,Waitemata,0,293,4,297
2021-01-17,Wairarapa,0,8,0,8
2021-01-17,Waikato,0,192,2,194
2021-01-17,Taranaki,0,16,0,16
2021-01-17,Tairawhiti,0,4,0,4
2021-01-17,Southern,0,214,2,216
2021-01-17,South Canterbury,0,17,0,17
2021-01-17,Northland,0,28,0,28
2021-01-17,Nelson Marlborough,0,49,0,49
2021-01-17,Mid Central,0,32,0,32
2021-01-17,Lakes,0,16,0,16
2021-01-17,Hutt Valley,0,24,0,24
2021-01-17,Hawke's Bay,0,44,0,44
2021-01-17,Counties Manukau,0,215,1,216
2021-01-17,Capital and Coast,0,94,2,96
2021-01-17,Canterbury,0,157,12,169
2021-01-17,Bay of Plenty,0,48,0,48
2021-01-17,Managed Isolation & Quarantine,82,459,0,541
2021-01-17,Total,82,2149,25,2256
2021-01-18,Auckland,0,226,1,227
2021-01-18,Whanganui,0,9,0,9
2021-01-18,West Coast,0,4,1,5
2021-01-18,Waitemata,0,293,4,297
2021-01-18,Wairarapa,0,8,0,8
2021-01-18,Waikato,0,192,2,194
2021-01-18,Taranaki,0,16,0,16
2021-01-18,Tairawhiti,0,4,0,4
2021-01-18,Southern,0,214,2,216
2021-01-18,South Canterbury,0,17,0,17
2021-01-18,Northland,0,28,0,28
2021-01-18,Nelson Marlborough,0,49,0,49
2021-01-18,Mid Central,0,32,0,32
2021-01-18,Lakes,0,16,0,16
2021-01-18,Hutt Valley,0,24,0,24
2021-01-18,Hawke's Bay,0,44,0,44
2021-01-18,Counties Manukau,0,215,1,216
2021-01-18,Capital and Coast,0,94,2,96
2021-01-18,Canterbury,0,157,12,169
2021-01-18,Bay of Plenty,0,48,0,48
2021-01-18,Managed Isolation & Quarantine,85,462,0,547
2021-01-18,Total,85,2152,25,2262
2021-01-20,Auckland,0,225,1,226
2021-01-20,Whanganui,0,9,0,9
2021-01-20,West Coast,0,4,1,5
2021-01-20,Waitemata,0,293,4,297
2021-01-20,Wairarapa,0,8,0,8
2021-01-20,Waikato,0,192,2,194
2021-01-20,Taranaki,0,16,0,16
2021-01-20,Tairawhiti,0,4,0,4
2021-01-20,Southern,0,214,2,216
2021-01-20,South Canterbury,0,17,0,17
2021-01-20,Northland,0,28,0,28
2021-01-20,Nelson Marlborough,0,49,0,49
2021-01-20,Mid Central,0,32,0,32
2021-01-20,Lakes,0,16,0,16
2021-01-20,Hutt Valley,0,24,0,24
2021-01-20,Hawke's Bay,0,44,0,44
2021-01-20,Counties Manukau,0,216,1,217
2021-01-20,Capital and Coast,0,94,2,96
2021-01-20,Canterbury,0,157,12,169
2021-01-20,Bay of Plenty,0,48,0,48
2021-01-20,Managed Isolation & Quarantine,76,476,0,552
2021-01-20,Total,76,2166,25,2267
2021-01-22,Auckland,0,226,1,227
2021-01-22,Whanganui,0,9,0,9
2021-01-22,West Coast,0,4,1,5
2021-01-22,Waitemata,0,293,4,297
2021-01-22,Wairarapa,0,8,0,8
2021-01-22,Waikato,0,192,2,194
2021-01-22,Taranaki,0,16,0,16
2021-01-22,Tairawhiti,0,4,0,4
2021-01-22,Southern,0,214,2,216
2021-01-22,South Canterbury,0,17,0,17
2021-01-22,Northland,0,28,0,28
2021-01-22,Nelson Marlborough,0,49,0,49
2021-01-22,Mid Central,0,32,0,32
2021-01-22,Lakes,0,16,0,16
2021-01-22,Hutt Valley,0,24,0,24
2021-01-22,Hawke's Bay,0,44,0,44
2021-01-22,Counties Manukau,0,216,1,217
2021-01-22,Capital and Coast,0,94,2,96
2021-01-22,Canterbury,0,157,12,169
2021-01-22,Bay of Plenty,0,48,0,48
2021-01-22,Managed Isolation & Quarantine,73,487,0,560
2021-01-22,Total,73,2178,25,2276
2021-01-24,Auckland,0,226,1,227
2021-01-24,Whanganui,0,9,0,9
2021-01-24,West Coast,0,4,1,5
2021-01-24,Waitemata,0,293,4,297
2021-01-24,Wairarapa,0,8,0,8
2021-01-24,Waikato,0,192,2,194
2021-01-24,Taranaki,0,16,0,16
2021-01-24,Tairawhiti,0,4,0,4
2021-01-24,Southern,0,214,2,216
2021-01-24,South Canterbury,0,17,0,17
2021-01-24,Northland,0,28,0,28
2021-01-24,Nelson Marlborough,0,49,0,49
2021-01-24,Mid Central,0,32,0,32
2021-01-24,Lakes,0,16,0,16
2021-01-24,Hutt Valley,0,24,0,24
2021-01-24,Hawke's Bay,0,44,0,44
2021-01-24,Counties Manukau,0,216,1,217
2021-01-24,Capital and Coast,0,94,2,96
2021-01-24,Canterbury,0,157,12,169
2021-01-24,Bay of Plenty,0,48,0,48
2021-01-24,Managed Isolation & Quarantine,79,488,0,567
2021-01-24,Total,79,2179,25,2283
2021-01-25,Auckland,0,226,1,227
2021-01-25,Whanganui,0,9,0,9
2021-01-25,West Coast,0,4,1,5
2021-01-25,Waitemata,0,293,4,297
2021-01-25,Wairarapa,0,8,0,8
2021-01-25,Waikato,0,192,2,194
2021-01-25,Taranaki,0,16,0,16
2021-01-25,Tairawhiti,0,4,0,4
2021-01-25,Southern,0,214,2,216
2021-01-25,South Canterbury,0,17,0,17
2021-01-25,Northland,0,28,0,28
2021-01-25,Nelson Marlborough,0,49,0,49
2021-01-25,Mid Central,0,32,0,32
2021-01-25,Lakes,0,16,0,16
2021-01-25,Hutt Valley,0,24,0,24
2021-01-25,Hawke's Bay,0,44,0,44
2021-01-25,Counties Manukau,0,216,1,217
2021-01-25,Capital and Coast,0,94,2,96
2021-01-25,Canterbury,0,157,12,169
2021-01-25,Bay of Plenty,0,48,0,48
2021-01-25,Managed Isolation & Quarantine,64,508,0,572
2021-01-25,Total,64,2199,25,2288
2021-01-26,Auckland,0,226,1,227
2021-01-26,Whanganui,0,9,0,9
2021-01-26,West Coast,0,4,1,5
2021-01-26,Waitemata,0,293,4,297
2021-01-26,Wairarapa,0,8,0,8
2021-01-26,Waikato,0,192,2,194
2021-01-26,Taranaki,0,16,0,16
2021-01-26,Tairawhiti,0,4,0,4
2021-01-26,Southern,0,214,2,216
2021-01-26,South Canterbury,0,17,0,17
2021-01-26,Northland,1,28,0,29
2021-01-26,Nelson Marlborough,0,49,0,49
2021-01-26,Mid Central,0,32,0,32
2021-01-26,Lakes,0,16,0,16
2021-01-26,Hutt Valley,0,24,0,24
2021-01-26,Hawke's Bay,0,44,0,44
2021-01-26,Counties Manukau,0,216,1,217
2021-01-26,Capital and Coast,0,94,2,96
2021-01-26,Canterbury,0,157,12,169
2021-01-26,Bay of Plenty,0,48,0,48
2021-01-26,Managed Isolation & Quarantine,64,509,0,573
2021-01-26,Total,65,2200,25,2290
2021-01-27,Auckland,0,225,1,227
2021-01-27,Whanganui,0,9,0,9
2021-01-27,West Coast,0,4,1,5
2021-01-27,Waitemata,0,293,4,297
2021-01-27,Wairarapa,0,8,0,8
2021-01-27,Waikato,0,192,2,194
2021-01-27,Taranaki,0,16,0,16
2021-01-27,Tairawhiti,0,4,0,4
2021-01-27,Southern,0,214,2,216
2021-01-27,South Canterbury,0,17,0,17
2021-01-27,Northland,0,29,0,29
2021-01-27,Nelson Marlborough,0,49,0,49
2021-01-27,Mid Central,0,32,0,32
2021-01-27,Lakes,0,16,0,16
2021-01-27,Hutt Valley,0,24,0,24
2021-01-27,Hawke's Bay,0,44,0,44
2021-01-27,Counties Manukau,0,216,1,217
2021-01-27,Capital and Coast,0,94,2,96
2021-01-27,Canterbury,0,157,12,169
2021-01-27,Bay of Plenty,0,48,0,48
2021-01-27,Managed Isolation & Quarantine,68,510,0,577
2021-01-27,Total,68,2201,25,2294
2021-01-28,Auckland,0,226,1,227
2021-01-28,Whanganui,0,9,0,9
2021-01-28,West Coast,0,4,1,5
2021-01-28,Waitemata,2,293,4,299
2021-01-28,Wairarapa,0,8,0,8
2021-01-28,Waikato,0,192,2,194
2021-01-28,Taranaki,0,16,0,16
2021-01-28,Tairawhiti,0,4,0,4
2021-01-28,Southern,0,214,2,216
2021-01-28,South Canterbury,0,17,0,17
2021-01-28,Northland,0,29,0,29
2021-01-28,Nelson Marlborough,0,49,0,49
2021-01-28,Mid Central,0,32,0,32
2021-01-28,Lakes,0,16,0,16
2021-01-28,Hutt Valley,0,24,0,24
2021-01-28,Hawke's Bay,0,44,0,44
2021-01-28,Counties Manukau,0,216,1,217
2021-01-28,Capital and Coast,0,94,2,96
2021-01-28,Canterbury,0,157,12,169
2021-01-28,Bay of Plenty,0,48,0,48
2021-01-28,Managed Isolation & Quarantine,67,513,0,580
2021-01-28,Total,69,2205,25,2299
2021-01-29,Auckland,0,226,1,227
2021-01-29,Whanganui,0,9,0,9
2021-01-29,West Coast,0,4,1,5
2021-01-29,Waitemata*,2,293,4,299
2021-01-29,Wairarapa,0,8,0,8
2021-01-29,Waikato,0,192,2,194
2021-01-29,Taranaki,0,16,0,16
2021-01-29,Tairawhiti,0,4,0,4
2021-01-29,Southern,0,214,2,216
2021-01-29,South Canterbury,0,17,0,17
2021-01-29,Northland,0,29,0,29
2021-01-29,Nelson Marlborough,0,49,0,49
2021-01-29,Mid Central,0,32,0,32
2021-01-29,Lakes,0,16,0,16
2021-01-29,Hutt Valley,0,24,0,24
2021-01-29,Hawke's Bay,0,44,0,44
2021-01-29,Counties Manukau,0,216,1,217
2021-01-29,Capital and Coast,0,94,2,96
2021-01-29,Canterbury,0,157,12,169
2021-01-29,Bay of Plenty,0,48,0,48
2021-01-29,Managed Isolation & Quarantine,70,516,0,586
2021-01-29,Total,72,2208,25,2305
2021-01-30,Auckland,0,225,1,226
2021-01-30,Whanganui,0,9,0,9
2021-01-30,West Coast,0,4,1,5
2021-01-30,Waitemata,2,293,4,299
2021-01-30,Wairarapa,0,8,0,8
2021-01-30,Waikato,0,192,2,194
2021-01-30,Taranaki,0,16,0,16
2021-01-30,Tairawhiti,0,4,0,4
2021-01-30,Southern,0,214,2,216
2021-01-30,South Canterbury,0,17,0,17
2021-01-30,Northland,0,29,0,29
2021-01-30,Nelson Marlborough,0,49,0,49
2021-01-30,Mid Central,0,32,0,32
2021-01-30,Lakes,0,16,0,16
2021-01-30,Hutt Valley,0,24,0,24
2021-01-30,Hawke's Bay,0,44,0,44
2021-01-30,Counties Manukau,0,216,1,217
2021-01-30,Capital and Coast,0,94,2,96
2021-01-30,Canterbury,0,156,12,168
2021-01-30,Bay of Plenty,0,48,0,48
2021-01-30,Managed Isolation & Quarantine,69,517,0,586
2021-01-30,Total,71,2207,25,2303
2021-01-31,Auckland,0,225,1,226
2021-01-31,Whanganui,0,9,0,9
2021-01-31,West Coast,0,4,1,5
2021-01-31,Waitemata,2,293,4,299
2021-01-31,Wairarapa,0,8,0,8
2021-01-31,Waikato,0,192,2,194
2021-01-31,Taranaki,0,16,0,16
2021-01-31,Tairawhiti,0,4,0,4
2021-01-31,Southern,0,214,2,216
2021-01-31,South Canterbury,0,17,0,17
2021-01-31,Northland,0,29,0,29
2021-01-31,Nelson Marlborough,0,49,0,49
2021-01-31,Mid Central,0,32,0,32
2021-01-31,Lakes,0,16,0,16
2021-01-31,Hutt Valley,0,24,0,24
2021-01-31,Hawke's Bay,0,44,0,44
2021-01-31,Counties Manukau,0,216,1,217
2021-01-31,Capital and Coast,0,94,2,96
2021-01-31,Canterbury,0,156,12,168
2021-01-31,Bay of Plenty,0,48,0,48
2021-01-31,Managed Isolation & Quarantine,69,518,0,587
2021-01-31,Total,71,2208,25,2304
2021-02-01,Auckland,0,225,1,226
2021-02-01,Whanganui,0,9,0,9
2021-02-01,West Coast,0,4,1,5
2021-02-01,Waitemata,2,293,4,299
2021-02-01,Wairarapa,0,8,0,8
2021-02-01,Waikato,0,192,2,194
2021-02-01,Taranaki,0,16,0,16
2021-02-01,Tairawhiti,0,4,0,4
2021-02-01,Southern,0,214,2,216
2021-02-01,South Canterbury,0,17,0,17
2021-02-01,Northland,0,29,0,29
2021-02-01,Nelson Marlborough,0,49,0,49
2021-02-01,Mid Central,0,32,0,32
2021-02-01,Lakes,0,16,0,16
2021-02-01,Hutt Valley,0,24,0,24
2021-02-01,Hawke's Bay,0,44,0,44
2021-02-01,Counties Manukau,0,216,1,217
2021-02-01,Capital and Coast,0,94,2,96
2021-02-01,Canterbury,0,156,12,168
2021-02-01,Bay of Plenty,0,48,0,48
2021-02-01,Managed Isolation & Quarantine,67,519,0,586
2021-02-01,Total,69,2209,25,2303
2021-02-02,Auckland,0,225,1,226
2021-02-02,Whanganui,0,9,0,9
2021-02-02,West Coast,0,4,1,5
2021-02-02,Waitemata,2,293,4,299
2021-02-02,Wairarapa,0,8,0,8
2021-02-02,Waikato,0,192,2,194
2021-02-02,Taranaki,0,16,0,16
2021-02-02,Tairawhiti,0,4,0,4
2021-02-02,Southern,0,214,2,216
2021-02-02,South Canterbury,0,17,0,17
2021-02-02,Northland,0,29,0,29
2021-02-02,Nelson Marlborough,0,49,0,49
2021-02-02,Mid Central,0,32,0,32
2021-02-02,Lakes,0,16,0,16
2021-02-02,Hutt Valley,0,24,0,24
2021-02-02,Hawke's Bay,0,44,0,44
2021-02-02,Counties Manukau,0,216,1,217
2021-02-02,Capital and Coast,0,94,2,96
2021-02-02,Canterbury,0,156,12,168
2021-02-02,Bay of Plenty,0,48,0,48
2021-02-02,Managed Isolation & Quarantine,70,520,0,590
2021-02-02,Total,72,2210,25,2307
2021-02-03,Auckland,0,225,1,226
2021-02-03,Whanganui,0,9,0,9
2021-02-03,West Coast,0,4,1,5
2021-02-03,Waitemata,2,293,4,299
2021-02-03,Wairarapa,0,8,0,8
2021-02-03,Waikato,0,192,2,194
2021-02-03,Taranaki,0,16,0,16
2021-02-03,Tairawhiti,0,4,0,4
2021-02-03,Southern,0,214,2,216
2021-02-03,South Canterbury,0,17,0,17
2021-02-03,Northland,0,29,0,29
2021-02-03,Nelson Marlborough,0,49,0,49
2021-02-03,Mid Central,0,32,0,32
2021-02-03,Lakes,0,16,0,16
2021-02-03,Hutt Valley,0,24,0,24
2021-02-03,Hawke's Bay,0,44,0,44
2021-02-03,Counties Manukau,0,216,1,217
2021-02-03,Capital and Coast,0,94,2,96
2021-02-03,Canterbury,0,156,12,168
2021-02-03,Bay of Plenty,0,48,0,48
2021-02-03,Managed Isolation & Quarantine,59,532,0,591
2021-02-03,Total,61,2222,25,2308
2021-02-04,Auckland,0,225,1,226
2021-02-04,Whanganui,0,9,0,9
2021-02-04,West Coast,0,4,1,5
2021-02-04,Waitemata,2,293,4,299
2021-02-04,Wairarapa,0,8,0,8
2021-02-04,Waikato,0,192,2,194
2021-02-04,Taranaki,0,16,0,16
2021-02-04,Tairawhiti,0,4,0,4
2021-02-04,Southern,0,214,2,216
2021-02-04,South Canterbury,0,17,0,17
2021-02-04,Northland,0,29,0,29
2021-02-04,Nelson Marlborough,0,49,0,49
2021-02-04,Mid Central,0,32,0,32
2021-02-04,Lakes,0,16,0,16
2021-02-04,Hutt Valley,0,24,0,24
2021-02-04,Hawke's Bay,0,44,0,44
2021-02-04,Counties Manukau,0,216,1,217
2021-02-04,Capital and Coast,0,94,2,96
2021-02-04,Canterbury,0,156,12,168
2021-02-04,Bay of Plenty,0,48,0,48
2021-02-04,Managed Isolation & Quarantine,58,538,0,596
2021-02-04,Total,60,2228,25,2313
2021-02-05,Auckland,0,225,1,226
2021-02-05,Whanganui,0,9,0,9
2021-02-05,West Coast,0,4,1,5
2021-02-05,Waitemata,3,293,4,300
2021-02-05,Wairarapa,0,8,0,8
2021-02-05,Waikato,0,192,2,194
2021-02-05,Taranaki,0,16,0,16
2021-02-05,Tairawhiti,0,4,0,4
2021-02-05,Southern,0,214,2,216
2021-02-05,South Canterbury,0,17,0,17
2021-02-05,Northland,0,29,0,29
2021-02-05,Nelson Marlborough,0,49,0,49
2021-02-05,Mid Central,0,32,0,32
2021-02-05,Lakes,0,16,0,16
2021-02-05,Hutt Valley,0,24,0,24
2021-02-05,Hawke's Bay,0,44,0,44
2021-02-05,Counties Manukau,0,216,1,217
2021-02-05,Capital and Coast,0,94,2,96
2021-02-05,Canterbury,0,156,12,168
2021-02-05,Bay of Plenty,0,48,0,48
2021-02-05,Managed Isolation & Quarantine,59,538,0,597
2021-02-05,Total,62,2228,25,2315
2021-02-07,Auckland,0,225,1,226
2021-02-07,Whanganui,0,9,0,9
2021-02-07,West Coast,0,4,1,5
2021-02-07,Waitemata,3,293,4,300
2021-02-07,Wairarapa,0,8,0,8
2021-02-07,Waikato,0,192,2,194
2021-02-07,Taranaki,0,16,0,16
2021-02-07,Tairawhiti,0,4,0,4
2021-02-07,Southern,0,214,2,216
2021-02-07,South Canterbury,0,17,0,17
2021-02-07,Northland,0,29,0,29
2021-02-07,Nelson Marlborough,0,49,0,49
2021-02-07,Mid Central,0,32,0,32
2021-02-07,Lakes,0,16,0,16
2021-02-07,Hutt Valley,0,24,0,24
2021-02-07,Hawke's Bay,0,44,0,44
2021-02-07,Counties Manukau,1,216,1,218
2021-02-07,Capital and Coast,0,94,2,96
2021-02-07,Canterbury,0,156,12,168
2021-02-07,Bay of Plenty,0,48,0,48
2021-02-07,Managed Isolation & Quarantine,62,539,0,601
2021-02-07,Total,66,2229,25,2320
2021-02-08,Auckland,0,225,1,226
2021-02-08,Whanganui,0,9,0,9
2021-02-08,West Coast,0,4,1,5
2021-02-08,Waitemata,3,293,4,300
2021-02-08,Wairarapa,0,8,0,8
2021-02-08,Waikato,1,192,2,195
2021-02-08,Taranaki,0,16,0,16
2021-02-08,Tairawhiti,0,4,0,4
2021-02-08,Southern,0,214,2,216
2021-02-08,South Canterbury,0,17,0,17
2021-02-08,Northland,0,29,0,29
2021-02-08,Nelson Marlborough,0,49,0,49
2021-02-08,Mid Central,0,32,0,32
2021-02-08,Lakes,0,16,0,16
2021-02-08,Hutt Valley,0,24,0,24
2021-02-08,Hawke's Bay,0,44,0,44
2021-02-08,Counties Manukau,0,216,1,217
2021-02-08,Capital and Coast,0,94,2,96
2021-02-08,Canterbury,0,156,12,168
2021-02-08,Bay of Plenty,0,48,0,48
2021-02-08,Managed Isolation & Quarantine,62,539,0,601
2021-02-08,Total,66,2229,25,2320
2021-02-09,Auckland,0,225,1,226
2021-02-09,Whanganui,0,9,0,9
2021-02-09,West Coast,0,4,1,5
2021-02-09,Waitemata,3,293,4,300
2021-02-09,Wairarapa,0,8,0,8
2021-02-09,Waikato,1,192,2,195
2021-02-09,Taranaki,0,16,0,16
2021-02-09,Tairawhiti,0,4,0,4
2021-02-09,Southern,0,214,2,216
2021-02-09,South Canterbury,0,17,0,17
2021-02-09,Northland,0,29,0,29
2021-02-09,Nelson Marlborough,0,49,0,49
2021-02-09,Mid Central,0,32,0,32
2021-02-09,Lakes,0,16,0,16
2021-02-09,Hutt Valley,0,24,0,24
2021-02-09,Hawke's Bay,0,44,0,44
2021-02-09,Counties Manukau,0,216,1,217
2021-02-09,Capital and Coast,0,94,2,96
2021-02-09,Canterbury,0,156,12,168
2021-02-09,Bay of Plenty,0,48,0,48
2021-02-09,Managed Isolation & Quarantine,63,540,0,603
2021-02-09,Total,67,2230,25,2322
2021-02-10,Auckland,0,225,1,226
2021-02-10,Whanganui,0,9,0,9
2021-02-10,West Coast,0,4,1,5
2021-02-10,Waitemata,1,295,4,300
2021-02-10,Wairarapa,0,8,0,8
2021-02-10,Waikato,0,193,2,195
2021-02-10,Taranaki,0,16,0,16
2021-02-10,Tairawhiti,0,4,0,4
2021-02-10,Southern,0,214,2,216
2021-02-10,South Canterbury,0,17,0,17
2021-02-10,Northland,0,29,0,29
2021-02-10,Nelson Marlborough,0,49,0,49
2021-02-10,Mid Central,0,32,0,32
2021-02-10,Lakes,0,16,0,16
2021-02-10,Hutt Valley,0,24,0,24
2021-02-10,Hawke's Bay,0,44,0,44
2021-02-10,Counties Manukau,0,216,1,217
2021-02-10,Capital and Coast,0,94,2,96
2021-02-10,Canterbury,0,156,12,168
2021-02-10,Bay of Plenty,0,48,0,48
2021-02-10,Managed Isolation & Quarantine,58,547,0,605
2021-02-10,Total,59,2240,25,2324
2021-02-11,Auckland,0,225,1,226
2021-02-11,Whanganui,0,9,0,9
2021-02-11,West Coast,0,4,1,5
2021-02-11,Waitemata,1,295,4,300
2021-02-11,Wairarapa,0,8,0,8
2021-02-11,Waikato,0,193,2,195
2021-02-11,Taranaki,0,16,0,16
2021-02-11,Tairawhiti,0,4,0,4
2021-02-11,Southern,0,214,2,216
2021-02-11,South Canterbury,0,17,0,17
2021-02-11,Northland,0,29,0,29
2021-02-11,Nelson Marlborough,0,49,0,49
2021-02-11,Mid Central,0,32,0,32
2021-02-11,Lakes,0,16,0,16
2021-02-11,Hutt Valley,0,24,0,24
2021-02-11,Hawke's Bay,0,44,0,44
2021-02-11,Counties Manukau,0,216,1,217
2021-02-11,Capital and Coast,0,94,2,96
2021-02-11,Canterbury,0,156,12,168
2021-02-11,Bay of Plenty,0,48,0,48
2021-02-11,Managed Isolation & Quarantine,53,552,0,605
2021-02-11,Total,54,2245,25,2324
2021-02-12,Auckland,0,225,1,226
2021-02-12,Whanganui,0,9,0,9
2021-02-12,West Coast,0,4,1,5
2021-02-12,Waitemata,1,295,4,300
2021-02-12,Wairarapa,0,8,0,8
2021-02-12,Waikato,0,193,2,195
2021-02-12,Taranaki,0,16,0,16
2021-02-12,Tairawhiti,0,4,0,4
2021-02-12,Southern,0,214,2,216
2021-02-12,South Canterbury,0,17,0,17
2021-02-12,Northland,0,29,0,29
2021-02-12,Nelson Marlborough,0,49,0,49
2021-02-12,Mid Central,0,32,0,32
2021-02-12,Lakes,0,16,0,16
2021-02-12,Hutt Valley,0,24,0,24
2021-02-12,Hawke's Bay,0,44,0,44
2021-02-12,Counties Manukau,0,216,1,217
2021-02-12,Capital and Coast,0,94,2,96
2021-02-12,Canterbury,0,156,12,168
2021-02-12,Bay of Plenty,0,48,0,48
2021-02-12,Managed Isolation & Quarantine,43,564,0,607
2021-02-12,Total,44,2257,25,2326
2021-02-13,Auckland,0,225,1,226
2021-02-13,Whanganui,0,9,0,9
2021-02-13,West Coast,0,4,1,5
2021-02-13,Waitemata,1,295,4,300
2021-02-13,Wairarapa,0,8,0,8
2021-02-13,Waikato,0,193,2,195
2021-02-13,Taranaki,0,16,0,16
2021-02-13,Tairawhiti,0,4,0,4
2021-02-13,Southern,0,214,2,216
2021-02-13,South Canterbury,0,17,0,17
2021-02-13,Northland,0,29,0,29
2021-02-13,Nelson Marlborough,0,49,0,49
2021-02-13,Mid Central,0,32,0,32
2021-02-13,Lakes,0,16,0,16
2021-02-13,Hutt Valley,0,24,0,24
2021-02-13,Hawke's Bay,0,44,0,44
2021-02-13,Counties Manukau,0,216,1,217
2021-02-13,Capital and Coast,0,94,2,96
2021-02-13,Canterbury,0,156,12,168
2021-02-13,Bay of Plenty,0,48,0,48
2021-02-13,Managed Isolation & Quarantine,44,565,0,609
2021-02-13,Total,45,2258,25,2328
2021-02-14,Auckland,0,225,1,226
2021-02-14,Whanganui,0,9,0,9
2021-02-14,West Coast,0,4,1,5
2021-02-14,Waitemata,1,295,4,300
2021-02-14,Wairarapa,0,8,0,8
2021-02-14,Waikato,0,193,2,195
2021-02-14,Taranaki,0,16,0,16
2021-02-14,Tairawhiti,0,4,0,4
2021-02-14,Southern,0,214,2,216
2021-02-14,South Canterbury,0,17,0,17
2021-02-14,Northland,0,29,0,29
2021-02-14,Nelson Marlborough,0,49,0,49
2021-02-14,Mid Central,0,32,0,32
2021-02-14,Lakes,0,16,0,16
2021-02-14,Hutt Valley,0,24,0,24
2021-02-14,Hawke's Bay,0,44,0,44
2021-02-14,Counties Manukau,2,216,1,219
2021-02-14,Capital and Coast,0,94,2,96
2021-02-14,Canterbury,0,156,12,168
2021-02-14,Bay of Plenty,0,48,0,48
2021-02-14,Managed Isolation & Quarantine,44,565,0,609
2021-02-14,Total,47,2258,25,2330
2021-02-15,Auckland,0,225,1,226
2021-02-15,Whanganui,0,9,0,9
2021-02-15,West Coast,0,4,1,5
2021-02-15,Waitemata,0,296,4,300
2021-02-15,Wairarapa,0,8,0,8
2021-02-15,Waikato,0,193,2,195
2021-02-15,Taranaki,0,16,0,16
2021-02-15,Tairawhiti,0,4,0,4
2021-02-15,Southern,0,214,2,216
2021-02-15,South Canterbury,0,17,0,17
2021-02-15,Northland,0,29,0,29
2021-02-15,Nelson Marlborough,0,49,0,49
2021-02-15,Mid Central,0,32,0,32
2021-02-15,Lakes,0,16,0,16
2021-02-15,Hutt Valley,0,24,0,24
2021-02-15,Hawke's Bay,0,44,0,44
2021-02-15,Counties Manukau,3,216,1,220
2021-02-15,Capital and Coast,0,94,2,96
2021-02-15,Canterbury,0,156,12,168
2021-02-15,Bay of Plenty,0,48,0,48
2021-02-15,Managed Isolation & Quarantine,44,570,0,614
2021-02-15,Total,47,2264,25,2336
2021-02-16,Auckland,0,225,1,226
2021-02-16,Whanganui,0,9,0,9
2021-02-16,West Coast,0,4,1,5
2021-02-16,Waitemata,0,296,4,300
2021-02-16,Wairarapa,0,8,0,8
2021-02-16,Waikato,0,193,2,195
2021-02-16,Taranaki,0,16,0,16
2021-02-16,Tairawhiti,0,4,0,4
2021-02-16,Southern,0,214,2,216
2021-02-16,South Canterbury,0,17,0,17
2021-02-16,Northland,0,29,0,29
2021-02-16,Nelson Marlborough,0,49,0,49
2021-02-16,Mid Central,0,32,0,32
2021-02-16,Lakes,0,16,0,16
2021-02-16,Hutt Valley,0,24,0,24
2021-02-16,Hawke's Bay,0,44,0,44
2021-02-16,Counties Manukau,3,216,1,220
2021-02-16,Capital and Coast,0,94,2,96
2021-02-16,Canterbury,0,156,12,168
2021-02-16,Bay of Plenty,0,48,0,48
2021-02-16,Managed Isolation & Quarantine,43,571,1,615
2021-02-16,Total,46,2265,26,2337
2021-02-17,Auckland,0,225,1,226
2021-02-17,Whanganui,0,9,0,9
2021-02-17,West Coast,0,4,1,5
2021-02-17,Waitemata,0,296,4,300
2021-02-17,Wairarapa,0,8,0,8
2021-02-17,Waikato,0,193,2,195
2021-02-17,Taranaki,0,16,0,16
2021-02-17,Tairawhiti,0,4,0,4
2021-02-17,Southern,0,214,2,216
2021-02-17,South Canterbury,0,17,0,17
2021-02-17,Northland,0,29,0,29
2021-02-17,Nelson Marlborough,0,49,0,49
2021-02-17,Mid Central,0,32,0,32
2021-02-17,Lakes,0,16,0,16
2021-02-17,Hutt Valley,0,24,0,24
2021-02-17,Hawke's Bay,0,44,0,44
2021-02-17,Counties Manukau,5,216,1,222
2021-02-17,Capital and Coast,0,94,2,96
2021-02-17,Canterbury,0,156,12,168
2021-02-17,Bay of Plenty,0,48,0,48
2021-02-17,Managed Isolation & Quarantine,44,571,1,616
2021-02-17,Total,49,2265,26,2340
2021-02-18,Auckland,0,225,1,226
2021-02-18,Whanganui,0,9,0,9
2021-02-18,West Coast,0,4,1,5
2021-02-18,Waitemata,0,296,4,300
2021-02-18,Wairarapa,0,8,0,8
2021-02-18,Waikato,0,193,2,195
2021-02-18,Taranaki,0,16,0,16
2021-02-18,Tairawhiti,0,4,0,4
2021-02-18,Southern,0,214,2,216
2021-02-18,South Canterbury,0,17,0,17
2021-02-18,Northland,0,29,0,29
2021-02-18,Nelson Marlborough,0,49,0,49
2021-02-18,Mid Central,0,32,0,32
2021-02-18,Lakes,0,16,0,16
2021-02-18,Hutt Valley,0,24,0,24
2021-02-18,Hawke's Bay,0,44,0,44
2021-02-18,Counties Manukau,6,216,1,223
2021-02-18,Capital and Coast,0,94,2,96
2021-02-18,Canterbury,0,156,12,168
2021-02-18,Bay of Plenty,0,48,0,48
2021-02-18,Managed Isolation & Quarantine,40,578,1,619
2021-02-18,Total,46,2272,26,2344
2021-02-19,Auckland,0,225,1,226
2021-02-19,Whanganui,0,9,0,9
2021-02-19,West Coast,0,4,1,5
2021-02-19,Waitemata,0,296,4,300
2021-02-19,Wairarapa,0,8,0,8
2021-02-19,Waikato,0,193,2,195
2021-02-19,Taranaki,0,16,0,16
2021-02-19,Tairawhiti,0,4,0,4
2021-02-19,Southern,0,214,2,216
2021-02-19,South Canterbury,0,17,0,17
2021-02-19,Northland,0,29,0,29
2021-02-19,Nelson Marlborough,0,49,0,49
2021-02-19,Mid Central,0,32,0,32
2021-02-19,Lakes,0,16,0,16
2021-02-19,Hutt Valley,0,24,0,24
2021-02-19,Hawke's Bay,0,44,0,44
2021-02-19,Counties Manukau,7,216,1,224
2021-02-19,Capital and Coast,0,94,2,96
2021-02-19,Canterbury,0,156,12,168
2021-02-19,Bay of Plenty,0,48,0,48
2021-02-19,Managed Isolation & Quarantine,43,578,1,622
2021-02-19,Total,50,2272,26,2348
2021-02-20,Auckland,0,225,1,226
2021-02-20,Whanganui,0,9,0,9
2021-02-20,West Coast,0,4,1,5
2021-02-20,Waitemata,0,296,4,300
2021-02-20,Wairarapa,0,8,0,8
2021-02-20,Waikato,0,193,2,195
2021-02-20,Taranaki,0,16,0,16
2021-02-20,Tairawhiti,0,4,0,4
2021-02-20,Southern,0,214,2,216
2021-02-20,South Canterbury,0,17,0,17
2021-02-20,Northland,0,29,0,29
2021-02-20,Nelson Marlborough,0,49,0,49
2021-02-20,Mid Central,0,32,0,32
2021-02-20,Lakes,0,16,0,16
2021-02-20,Hutt Valley,0,24,0,24
2021-02-20,Hawke's Bay,0,44,0,44
2021-02-20,Counties Manukau,7,216,1,224
2021-02-20,Capital and Coast,0,94,2,96
2021-02-20,Canterbury,0,156,12,168
2021-02-20,Bay of Plenty,0,48,0,48
2021-02-20,Managed Isolation & Quarantine,44,579,1,624
2021-02-20,Total,51,2273,26,2350
2021-02-21,Auckland,0,225,1,226
2021-02-21,Whanganui,0,9,0,9
2021-02-21,West Coast,0,4,1,5
2021-02-21,Waitemata,0,296,4,300
2021-02-21,Wairarapa,0,8,0,8
2021-02-21,Waikato,0,193,2,195
2021-02-21,Taranaki,0,16,0,16
2021-02-21,Tairawhiti,0,4,0,4
2021-02-21,Southern,0,214,2,216
2021-02-21,South Canterbury,0,17,0,17
2021-02-21,Northland,0,29,0,29
2021-02-21,Nelson Marlborough,0,49,0,49
2021-02-21,Mid Central,0,32,0,32
2021-02-21,Lakes,0,16,0,16
2021-02-21,Hutt Valley,0,24,0,24
2021-02-21,Hawke's Bay,0,44,0,44
2021-02-21,Counties Manukau,7,216,1,224
2021-02-21,Capital and Coast,0,94,2,96
2021-02-21,Canterbury,0,156,12,168
2021-02-21,Bay of Plenty,0,48,0,48
2021-02-21,Managed Isolation & Quarantine,44,579,1,624
2021-02-21,Total,51,2273,26,2350
2021-02-22,Auckland,0,225,1,226
2021-02-22,Whanganui,0,9,0,9
2021-02-22,West Coast,0,4,1,5
2021-02-22,Waitemata,0,296,4,300
2021-02-22,Wairarapa,0,8,0,8
2021-02-22,Waikato,0,193,2,195
2021-02-22,Taranaki,0,16,0,16
2021-02-22,Tairawhiti,0,4,0,4
2021-02-22,Southern,0,214,2,216
2021-02-22,South Canterbury,0,17,0,17
2021-02-22,Northland,0,29,0,29
2021-02-22,Nelson Marlborough,0,49,0,49
2021-02-22,Mid Central,0,32,0,32
2021-02-22,Lakes,0,16,0,16
2021-02-22,Hutt Valley,0,24,0,24
2021-02-22,Hawke's Bay,0,44,0,44
2021-02-22,Counties Manukau,8,216,1,225
2021-02-22,Capital and Coast,0,94,2,96
2021-02-22,Canterbury,0,156,12,168
2021-02-22,Bay of Plenty,0,48,0,48
2021-02-22,Managed Isolation & Quarantine,46,583,1,630
2021-02-22,Total,54,2277,26,2357
2021-02-23,Auckland,0,225,1,226
2021-02-23,Whanganui,0,9,0,9
2021-02-23,West Coast,0,4,1,5
2021-02-23,Waitemata,0,296,4,300
2021-02-23,Wairarapa,0,8,0,8
2021-02-23,Waikato,0,193,2,195
2021-02-23,Taranaki,0,16,0,16
2021-02-23,Tairawhiti,0,4,0,4
2021-02-23,Southern,0,214,2,216
2021-02-23,South Canterbury,0,17,0,17
2021-02-23,Northland,0,29,0,29
2021-02-23,Nelson Marlborough,0,49,0,49
2021-02-23,Mid Central,0,32,0,32
2021-02-23,Lakes,0,16,0,16
2021-02-23,Hutt Valley,0,24,0,24
2021-02-23,Hawke's Bay,0,44,0,44
2021-02-23,Counties Manukau,9,216,1,226
2021-02-23,Capital and Coast,0,94,2,96
2021-02-23,Canterbury,0,156,12,168
2021-02-23,Bay of Plenty,0,48,0,48
2021-02-23,Managed Isolation & Quarantine,51,583,1,635
2021-02-23,Total,60,2277,26,2363
2021-02-24,Auckland,0,225,1,226
2021-02-24,Whanganui,0,9,0,9
2021-02-24,West Coast,0,4,1,5
2021-02-24,Waitemata,0,296,4,300
2021-02-24,Wairarapa,0,8,0,8
2021-02-24,Waikato,0,193,2,195
2021-02-24,Taranaki,0,16,0,16
2021-02-24,Tairawhiti,0,4,0,4
2021-02-24,Southern,0,214,2,216
2021-02-24,South Canterbury,0,17,0,17
2021-02-24,Northland,0,29,0,29
2021-02-24,Nelson Marlborough,0,49,0,49
2021-02-24,Mid Central,0,32,0,32
2021-02-24,Lakes,0,16,0,16
2021-02-24,Hutt Valley,0,24,0,24
2021-02-24,Hawke's Bay,0,44,0,44
2021-02-24,Counties Manukau,11,216,1,228
2021-02-24,Capital and Coast,0,94,2,96
2021-02-24,Canterbury,0,156,12,168
2021-02-24,Bay of Plenty,0,48,0,48
2021-02-24,Managed Isolation & Quarantine,51,583,1,635
2021-02-24,Total,62,2277,26,2365
2021-02-25,Auckland,0,225,1,226
2021-02-25,Whanganui,0,9,0,9
2021-02-25,West Coast,0,4,1,5
2021-02-25,Waitemata,0,296,4,300
2021-02-25,Wairarapa,0,8,0,8
2021-02-25,Waikato,0,193,2,195
2021-02-25,Taranaki,0,16,0,16
2021-02-25,Tairawhiti,0,4,0,4
2021-02-25,Southern,0,214,2,216
2021-02-25,South Canterbury,0,17,0,17
2021-02-25,Northland,0,29,0,29
2021-02-25,Nelson Marlborough,0,49,0,49
2021-02-25,Mid Central,0,32,0,32
2021-02-25,Lakes,0,16,0,16
2021-02-25,Hutt Valley,0,24,0,24
2021-02-25,Hawke's Bay,0,44,0,44
2021-02-25,Counties Manukau,11,216,1,228
2021-02-25,Capital and Coast,0,94,2,96
2021-02-25,Canterbury,0,156,12,168
2021-02-25,Bay of Plenty,0,48,0,48
2021-02-25,Managed Isolation & Quarantine,54,583,1,638
2021-02-25,Total,65,2277,26,2368
2021-02-26,Auckland,0,225,1,226
2021-02-26,Whanganui,0,9,0,9
2021-02-26,West Coast,0,4,1,5
2021-02-26,Waitemata,0,296,4,300
2021-02-26,Wairarapa,0,8,0,8
2021-02-26,Waikato,0,193,2,195
2021-02-26,Taranaki,0,16,0,16
2021-02-26,Tairawhiti,0,4,0,4
2021-02-26,Southern,0,214,2,216
2021-02-26,South Canterbury,0,17,0,17
2021-02-26,Northland,0,29,0,29
2021-02-26,Nelson Marlborough,0,49,0,49
2021-02-26,Mid Central,0,32,0,32
2021-02-26,Lakes,0,16,0,16
2021-02-26,Hutt Valley,0,24,0,24
2021-02-26,Hawke's Bay,0,44,0,44
2021-02-26,Counties Manukau,11,217,1,229
2021-02-26,Capital and Coast,0,94,2,96
2021-02-26,Canterbury,0,156,12,168
2021-02-26,Bay of Plenty,0,48,0,48
2021-02-26,Managed Isolation & Quarantine,56,583,1,640
2021-02-26,Total,67,2278,26,2371
2021-02-27,Auckland,0,225,1,226
2021-02-27,Whanganui,0,9,0,9
2021-02-27,West Coast,0,4,1,5
2021-02-27,Waitemata,0,296,4,300
2021-02-27,Wairarapa,0,8,0,8
2021-02-27,Waikato,0,193,2,195
2021-02-27,Taranaki,0,16,0,16
2021-02-27,Tairawhiti,0,4,0,4
2021-02-27,Southern,0,214,2,216
2021-02-27,South Canterbury,0,17,0,17
2021-02-27,Northland,0,29,0,29
2021-02-27,Nelson Marlborough,0,49,0,49
2021-02-27,Mid Central,0,32,0,32
2021-02-27,Lakes,0,16,0,16
2021-02-27,Hutt Valley,0,24,0,24
2021-02-27,Hawke's Bay,0,44,0,44
2021-02-27,Counties Manukau,11,217,1,229
2021-02-27,Capital and Coast,0,94,2,96
2021-02-27,Canterbury,0,156,12,168
2021-02-27,Bay of Plenty,0,48,0,48
2021-02-27,Managed Isolation & Quarantine,55,585,1,641
2021-02-27,Total,66,2280,26,2372
2021-02-28,Auckland,0,225,1,226
2021-02-28,Whanganui,0,9,0,9
2021-02-28,West Coast,0,4,1,5
2021-02-28,Waitemata,0,296,4,300
2021-02-28,Wairarapa,0,8,0,8
2021-02-28,Waikato,0,193,2,195
2021-02-28,Taranaki,0,16,0,16
2021-02-28,Tairawhiti,0,4,0,4
2021-02-28,Southern,0,214,2,216
2021-02-28,South Canterbury,0,17,0,17
2021-02-28,Northland,0,29,0,29
2021-02-28,Nelson Marlborough,0,49,0,49
2021-02-28,Mid Central,0,32,0,32
2021-02-28,Lakes,0,16,0,16
2021-02-28,Hutt Valley,0,24,0,24
2021-02-28,Hawke's Bay,0,44,0,44
2021-02-28,Counties Manukau,11,219,1,231
2021-02-28,Capital and Coast,0,94,2,96
2021-02-28,Canterbury,0,156,12,168
2021-02-28,Bay of Plenty,0,48,0,48
2021-02-28,Managed Isolation & Quarantine,54,588,1,643
2021-02-28,Total,65,2285,26,2376
2021-03-01,Auckland,0,225,1,226
2021-03-01,Whanganui,0,9,0,9
2021-03-01,West Coast,0,4,1,5
2021-03-01,Waitemata,0,296,4,300
2021-03-01,Wairarapa,0,8,0,8
2021-03-01,Waikato,0,193,2,195
2021-03-01,Taranaki,0,16,0,16
2021-03-01,Tairawhiti,0,4,0,4
2021-03-01,Southern,0,214,2,216
2021-03-01,South Canterbury,0,17,0,17
2021-03-01,Northland,0,29,0,29
2021-03-01,Nelson Marlborough,0,49,0,49
2021-03-01,Mid Central,0,32,0,32
2021-03-01,Lakes,0,16,0,16
2021-03-01,Hutt Valley,0,24,0,24
2021-03-01,Hawke's Bay,0,44,0,44
2021-03-01,Counties Manukau,12,219,1,232
2021-03-01,Capital and Coast,0,94,2,96
2021-03-01,Canterbury,0,156,12,168
2021-03-01,Bay of Plenty,0,48,0,48
2021-03-01,Managed Isolation & Quarantine,55,588,1,644
2021-03-01,Total,67,2285,26,2378
2021-03-02,Auckland,0,225,1,226
2021-03-02,Whanganui,0,9,0,9
2021-03-02,West Coast,0,4,1,5
2021-03-02,Waitemata,0,296,4,300
2021-03-02,Wairarapa,0,8,0,8
2021-03-02,Waikato,0,193,2,195
2021-03-02,Taranaki,0,16,0,16
2021-03-02,Tairawhiti,0,4,0,4
2021-03-02,Southern,0,214,2,216
2021-03-02,South Canterbury,0,17,0,17
2021-03-02,Northland,0,29,0,29
2021-03-02,Nelson Marlborough,0,49,0,49
2021-03-02,Mid Central,0,32,0,32
2021-03-02,Lakes,0,16,0,16
2021-03-02,Hutt Valley,0,24,0,24
2021-03-02,Hawke's Bay,0,44,0,44
2021-03-02,Counties Manukau,10,221,1,232
2021-03-02,Capital and Coast,0,94,2,96
2021-03-02,Canterbury,0,156,12,168
2021-03-02,Bay of Plenty,0,48,0,48
2021-03-02,Managed Isolation & Quarantine,59,588,1,648
2021-03-02,Total,69,2287,26,2382
2021-03-03,Auckland,0,225,1,226
2021-03-03,Whanganui,0,9,0,9
2021-03-03,West Coast,0,4,1,5
2021-03-03,Waitemata,0,296,4,300
2021-03-03,Wairarapa,0,8,0,8
2021-03-03,Waikato,0,193,2,195
2021-03-03,Taranaki,0,16,0,16
2021-03-03,Tairawhiti,0,4,0,4
2021-03-03,Southern,0,214,2,216
2021-03-03,South Canterbury,0,17,0,17
2021-03-03,Northland,0,29,0,29
2021-03-03,Nelson Marlborough,0,49,0,49
2021-03-03,Mid Central,0,32,0,32
2021-03-03,Lakes,0,16,0,16
2021-03-03,Hutt Valley,0,24,0,24
2021-03-03,Hawke's Bay,0,44,0,44
2021-03-03,Counties Manukau,9,222,1,232
2021-03-03,Capital and Coast,0,94,2,96
2021-03-03,Canterbury,0,156,12,168
2021-03-03,Bay of Plenty,0,48,0,48
2021-03-03,Managed Isolation & Quarantine,53,596,1,650
2021-03-03,Total,62,2296,26,2384
2021-03-04,Auckland,0,225,1,226
2021-03-04,Whanganui,0,9,0,9
2021-03-04,West Coast,0,4,1,5
2021-03-04,Waitemata,0,296,4,300
2021-03-04,Wairarapa,0,8,0,8
2021-03-04,Waikato,0,193,2,195
2021-03-04,Taranaki,0,16,0,16
2021-03-04,Tairawhiti,0,4,0,4
2021-03-04,Southern,0,214,2,216
2021-03-04,South Canterbury,0,17,0,17
2021-03-04,Northland,0,29,0,29
2021-03-04,Nelson Marlborough,0,49,0,49
2021-03-04,Mid Central,0,32,0,32
2021-03-04,Lakes,0,16,0,16
2021-03-04,Hutt Valley,0,24,0,24
2021-03-04,Hawke's Bay,0,44,0,44
2021-03-04,Counties Manukau,9,222,1,232
2021-03-04,Capital and Coast,0,94,2,96
2021-03-04,Canterbury,0,156,12,168
2021-03-04,Bay of Plenty,0,48,0,48
2021-03-04,Managed Isolation & Quarantine,59,595,1,655
2021-03-04,Total,68,2295,26,2389
2021-03-05,Auckland,0,225,1,226
2021-03-05,Whanganui,0,9,0,9
2021-03-05,West Coast,0,4,1,5
2021-03-05,Waitemata,0,296,4,300
2021-03-05,Wairarapa,0,8,0,8
2021-03-05,Waikato,0,193,2,195
2021-03-05,Taranaki,0,16,0,16
2021-03-05,Tairawhiti,0,4,0,4
2021-03-05,Southern,0,214,2,216
2021-03-05,South Canterbury,0,17,0,17
2021-03-05,Northland,0,29,0,29
2021-03-05,Nelson Marlborough,0,49,0,49
2021-03-05,Mid Central,0,32,0,32
2021-03-05,Lakes,0,16,0,16
2021-03-05,Hutt Valley,0,24,0,24
2021-03-05,Hawke's Bay,0,44,0,44
2021-03-05,Counties Manukau,9,222,1,232
2021-03-05,Capital and Coast,0,94,2,96
2021-03-05,Canterbury,0,156,12,168
2021-03-05,Bay of Plenty,0,48,0,48
2021-03-05,Managed Isolation & Quarantine,59,595,1,655
2021-03-05,Total,68,2295,26,2389
2021-03-06,Auckland,0,225,1,226
2021-03-06,Whanganui,0,9,0,9
2021-03-06,West Coast,0,4,1,5
2021-03-06,Waitemata,0,296,4,300
2021-03-06,Wairarapa,0,8,0,8
2021-03-06,Waikato,0,193,2,195
2021-03-06,Taranaki,0,16,0,16
2021-03-06,Tairawhiti,0,4,0,4
2021-03-06,Southern,0,214,2,216
2021-03-06,South Canterbury,0,17,0,17
2021-03-06,Northland,0,29,0,29
2021-03-06,Nelson Marlborough,0,49,0,49
2021-03-06,Mid Central,0,32,0,32
2021-03-06,Lakes,0,16,0,16
2021-03-06,Hutt Valley,0,24,0,24
2021-03-06,Hawke's Bay,0,44,0,44
2021-03-06,Counties Manukau,4,227,1,232
2021-03-06,Capital and Coast,0,94,2,96
2021-03-06,Canterbury,0,156,12,168
2021-03-06,Bay of Plenty,0,48,0,48
2021-03-06,Managed Isolation & Quarantine,67,596,1,664
2021-03-06,Total,71,2301,26,2398
2021-03-07,Auckland,0,225,1,226
2021-03-07,Whanganui,0,9,0,9
2021-03-07,West Coast,0,4,1,5
2021-03-07,Waitemata,0,296,4,300
2021-03-07,Wairarapa,0,8,0,8
2021-03-07,Waikato,0,193,2,195
2021-03-07,Taranaki,0,16,0,16
2021-03-07,Tairawhiti,0,4,0,4
2021-03-07,Southern,0,214,2,216
2021-03-07,South Canterbury,0,17,0,17
2021-03-07,Northland,0,29,0,29
2021-03-07,Nelson Marlborough,0,49,0,49
2021-03-07,Mid Central,0,32,0,32
2021-03-07,Lakes,0,16,0,16
2021-03-07,Hutt Valley,0,24,0,24
2021-03-07,Hawke's Bay,0,44,0,44
2021-03-07,Counties Manukau,4,227,1,232
2021-03-07,Capital and Coast,0,94,2,96
2021-03-07,Canterbury,0,156,12,168
2021-03-07,Bay of Plenty,0,48,0,48
2021-03-07,Managed Isolation & Quarantine,68,596,1,665
2021-03-07,Total,72,2301,26,2399
2021-03-08,Auckland,0,225,1,226
2021-03-08,Whanganui,0,9,0,9
2021-03-08,West Coast,0,4,1,5
2021-03-08,Waitemata,0,296,4,300
2021-03-08,Wairarapa,0,8,0,8
2021-03-08,Waikato,0,193,2,195
2021-03-08,Taranaki,0,16,0,16
2021-03-08,Tairawhiti,0,4,0,4
2021-03-08,Southern,0,214,2,216
2021-03-08,South Canterbury,0,17,0,17
2021-03-08,Northland,0,29,0,29
2021-03-08,Nelson Marlborough,0,49,0,49
2021-03-08,Mid Central,0,32,0,32
2021-03-08,Lakes,0,16,0,16
2021-03-08,Hutt Valley,0,24,0,24
2021-03-08,Hawke's Bay,0,44,0,44
2021-03-08,Counties Manukau,4,227,1,232
2021-03-08,Capital and Coast,0,94,2,96
2021-03-08,Canterbury,0,156,12,168
2021-03-08,Bay of Plenty,0,48,0,48
2021-03-08,Managed Isolation & Quarantine,74,596,1,671
2021-03-08,Total,78,2301,26,2405
2021-03-09,Auckland,0,225,1,226
2021-03-09,Whanganui,0,9,0,9
2021-03-09,West Coast,0,4,1,5
2021-03-09,Waitemata,0,296,4,300
2021-03-09,Wairarapa,0,8,0,8
2021-03-09,Waikato,0,193,2,195
2021-03-09,Taranaki,0,16,0,16
2021-03-09,Tairawhiti,0,4,0,4
2021-03-09,Southern,0,214,2,216
2021-03-09,South Canterbury,0,17,0,17
2021-03-09,Northland,0,29,0,29
2021-03-09,Nelson Marlborough,0,49,0,49
2021-03-09,Mid Central,0,32,0,32
2021-03-09,Lakes,0,16,0,16
2021-03-09,Hutt Valley,0,24,0,24
2021-03-09,Hawke's Bay,0,44,0,44
2021-03-09,Counties Manukau,2,229,1,232
2021-03-09,Capital and Coast,0,94,2,96
2021-03-09,Canterbury,0,156,12,168
2021-03-09,Bay of Plenty,0,48,0,48
2021-03-09,Managed Isolation & Quarantine,77,597,1,675
2021-03-09,Total,79,2304,26,2409
2021-03-10,Auckland,0,225,1,226
2021-03-10,Whanganui,0,9,0,9
2021-03-10,West Coast,0,4,1,5
2021-03-10,Waitemata,0,296,4,300
2021-03-10,Wairarapa,0,8,0,8
2021-03-10,Waikato,0,193,2,195
2021-03-10,Taranaki,0,16,0,16
2021-03-10,Tairawhiti,0,4,0,4
2021-03-10,Southern,0,214,2,216
2021-03-10,South Canterbury,0,17,0,17
2021-03-10,Northland,0,29,0,29
2021-03-10,Nelson Marlborough,0,49,0,49
2021-03-10,Mid Central,0,32,0,32
2021-03-10,Lakes,0,16,0,16
2021-03-10,Hutt Valley,0,24,0,24
2021-03-10,Hawke's Bay,0,44,0,44
2021-03-10,Counties Manukau,2,229,1,232
2021-03-10,Capital and Coast,0,94,2,96
2021-03-10,Canterbury,0,156,12,168
2021-03-10,Bay of Plenty,0,48,0,48
2021-03-10,Managed Isolation & Quarantine,78,597,1,676
2021-03-10,Total,80,2304,26,2410
2021-03-11,Auckland,0,225,1,226
2021-03-11,Whanganui,0,9,0,9
2021-03-11,West Coast,0,4,1,5
2021-03-11,Waitemata,0,296,4,300
2021-03-11,Wairarapa,0,8,0,8
2021-03-11,Waikato,0,193,2,195
2021-03-11,Taranaki,0,16,0,16
2021-03-11,Tairawhiti,0,4,0,4
2021-03-11,Southern,0,214,2,216
2021-03-11,South Canterbury,0,17,0,17
2021-03-11,Northland,0,29,0,29
2021-03-11,Nelson Marlborough,0,49,0,49
2021-03-11,Mid Central,0,32,0,32
2021-03-11,Lakes,0,16,0,16
2021-03-11,Hutt Valley,0,24,0,24
2021-03-11,Hawke's Bay,0,44,0,44
2021-03-11,Counties Manukau,1,230,1,232
2021-03-11,Capital and Coast,0,94,2,96
2021-03-11,Canterbury,0,156,12,168
2021-03-11,Bay of Plenty,0,48,0,48
2021-03-11,Managed Isolation & Quarantine,84,597,1,682
2021-03-11,Total,85,2305,26,2416
2021-03-12,Auckland,0,225,1,226
2021-03-12,Whanganui,0,9,0,9
2021-03-12,West Coast,0,4,1,5
2021-03-12,Waitemata,0,296,4,300
2021-03-12,Wairarapa,0,8,0,8
2021-03-12,Waikato,0,193,2,195
2021-03-12,Taranaki,0,16,0,16
2021-03-12,Tairawhiti,0,4,0,4
2021-03-12,Southern,0,214,2,216
2021-03-12,South Canterbury,0,17,0,17
2021-03-12,Northland,0,29,0,29
2021-03-12,Nelson Marlborough,0,49,0,49
2021-03-12,Mid Central,0,32,0,32
2021-03-12,Lakes,0,16,0,16
2021-03-12,Hutt Valley,0,24,0,24
2021-03-12,Hawke's Bay,0,44,0,44
2021-03-12,Counties Manukau,1,230,1,232
2021-03-12,Capital and Coast,0,94,2,96
2021-03-12,Canterbury,0,156,12,168
2021-03-12,Bay of Plenty,0,48,0,48
2021-03-12,Managed Isolation & Quarantine,85,597,1,683
2021-03-12,Total,86,2305,26,2417
2021-03-13,Auckland,0,225,1,226
2021-03-13,Whanganui,0,9,0,9
2021-03-13,West Coast,0,4,1,5
2021-03-13,Waitemata,0,298,4,302
2021-03-13,Wairarapa,0,8,0,8
2021-03-13,Waikato,0,193,2,195
2021-03-13,Taranaki,0,16,0,16
2021-03-13,Tairawhiti,0,4,0,4
2021-03-13,Southern,0,214,2,216
2021-03-13,South Canterbury,0,17,0,17
2021-03-13,Northland,0,29,0,29
2021-03-13,Nelson Marlborough,0,49,0,49
2021-03-13,Mid Central,0,32,0,32
2021-03-13,Lakes,0,16,0,16
2021-03-13,Hutt Valley,0,24,0,24
2021-03-13,Hawke's Bay,0,44,0,44
2021-03-13,Counties Manukau,0,231,1,232
2021-03-13,Capital and Coast,0,94,2,96
2021-03-13,Canterbury,0,156,12,168
2021-03-13,Bay of Plenty,0,48,0,48
2021-03-13,Managed Isolation & Quarantine,88,597,1,686
2021-03-13,Total,88,2308,26,2422
2021-03-14,Auckland,0,225,1,226
2021-03-14,Whanganui,0,9,0,9
2021-03-14,West Coast,0,4,1,5
2021-03-14,Waitemata,0,298,4,302
2021-03-14,Wairarapa,0,8,0,8
2021-03-14,Waikato,0,193,2,195
2021-03-14,Taranaki,0,16,0,16
2021-03-14,Tairawhiti,0,4,0,4
2021-03-14,Southern,0,214,2,216
2021-03-14,South Canterbury,0,17,0,17
2021-03-14,Northland,0,29,0,29
2021-03-14,Nelson Marlborough,0,49,0,49
2021-03-14,Mid Central,0,32,0,32
2021-03-14,Lakes,0,16,0,16
2021-03-14,Hutt Valley,0,24,0,24
2021-03-14,Hawke's Bay,0,44,0,44
2021-03-14,Counties Manukau,0,231,1,232
2021-03-14,Capital and Coast,0,94,2,96
2021-03-14,Canterbury,0,156,12,168
2021-03-14,Bay of Plenty,0,48,0,48
2021-03-14,Managed Isolation & Quarantine,87,599,1,687
2021-03-14,Total,87,2310,26,2423
2021-03-15,Auckland,0,225,1,226
2021-03-15,Whanganui,0,9,0,9
2021-03-15,West Coast,0,4,1,5
2021-03-15,Waitemata,0,298,4,302
2021-03-15,Wairarapa,0,8,0,8
2021-03-15,Waikato,0,193,2,195
2021-03-15,Taranaki,0,16,0,16
2021-03-15,Tairawhiti,0,4,0,4
2021-03-15,Southern,0,214,2,216
2021-03-15,South Canterbury,0,17,0,17
2021-03-15,Northland,0,29,0,29
2021-03-15,Nelson Marlborough,0,49,0,49
2021-03-15,Mid Central,0,32,0,32
2021-03-15,Lakes,0,16,0,16
2021-03-15,Hutt Valley,0,24,0,24
2021-03-15,Hawke's Bay,0,44,0,44
2021-03-15,Counties Manukau,0,231,1,232
2021-03-15,Capital and Coast,0,94,2,96
2021-03-15,Canterbury,0,156,12,168
2021-03-15,Bay of Plenty,0,48,0,48
2021-03-15,Managed Isolation & Quarantine,93,600,1,694
2021-03-15,Total,93,2311,26,2430
2021-03-16,Auckland,0,225,1,226
2021-03-16,Whanganui,0,9,0,9
2021-03-16,West Coast,0,4,1,5
2021-03-16,Waitemata,0,298,4,302
2021-03-16,Wairarapa,0,8,0,8
2021-03-16,Waikato,0,193,2,195
2021-03-16,Taranaki,0,16,0,16
2021-03-16,Tairawhiti,0,4,0,4
2021-03-16,Southern,0,214,2,216
2021-03-16,South Canterbury,0,17,0,17
2021-03-16,Northland,0,29,0,29
2021-03-16,Nelson Marlborough,0,49,0,49
2021-03-16,Mid Central,0,32,0,32
2021-03-16,Lakes,0,16,0,16
2021-03-16,Hutt Valley,0,24,0,24
2021-03-16,Hawke's Bay,0,44,0,44
2021-03-16,Counties Manukau,0,231,1,232
2021-03-16,Capital and Coast,0,94,2,96
2021-03-16,Canterbury,0,156,12,168
2021-03-16,Bay of Plenty,0,48,0,48
2021-03-16,Managed Isolation & Quarantine,95,600,1,696
2021-03-16,Total,95,2311,26,2432
2021-03-17,Auckland,0,225,1,226
2021-03-17,Whanganui,0,9,0,9
2021-03-17,West Coast,0,4,1,5
2021-03-17,Waitemata,0,298,4,302
2021-03-17,Wairarapa,0,8,0,8
2021-03-17,Waikato,0,193,2,195
2021-03-17,Taranaki,0,16,0,16
2021-03-17,Tairawhiti,0,4,0,4
2021-03-17,Southern,0,214,2,216
2021-03-17,South Canterbury,0,17,0,17
2021-03-17,Northland,0,29,0,29
2021-03-17,Nelson Marlborough,0,49,0,49
2021-03-17,Mid Central,0,32,0,32
2021-03-17,Lakes,0,16,0,16
2021-03-17,Hutt Valley,0,24,0,24
2021-03-17,Hawke's Bay,0,44,0,44
2021-03-17,Counties Manukau,0,231,1,232
2021-03-17,Capital and Coast,0,94,2,96
2021-03-17,Canterbury,0,156,12,168
2021-03-17,Bay of Plenty,0,48,0,48
2021-03-17,Managed Isolation & Quarantine,97,600,1,698
2021-03-17,Total,97,2311,26,2434
2021-03-19,Auckland,0,225,1,226
2021-03-19,Whanganui,0,9,0,9
2021-03-19,West Coast,0,4,1,5
2021-03-19,Waitemata,0,298,4,302
2021-03-19,Wairarapa,0,8,0,8
2021-03-19,Waikato,0,193,2,195
2021-03-19,Taranaki,0,16,0,16
2021-03-19,Tairawhiti,0,4,0,4
2021-03-19,Southern,0,214,2,216
2021-03-19,South Canterbury,0,17,0,17
2021-03-19,Northland,0,29,0,29
2021-03-19,Nelson Marlborough,0,49,0,49
2021-03-19,Mid Central,0,32,0,32
2021-03-19,Lakes,0,16,0,16
2021-03-19,Hutt Valley,0,24,0,24
2021-03-19,Hawke's Bay,0,44,0,44
2021-03-19,Counties Manukau,0,231,1,232
2021-03-19,Capital and Coast,0,94,2,96
2021-03-19,Canterbury,0,156,12,168
2021-03-19,Bay of Plenty,0,48,0,48
2021-03-19,Managed Isolation & Quarantine,55,652,1,708
2021-03-19,Total,55,2363,26,2444
2021-03-21,Auckland,0,225,1,226
2021-03-21,Whanganui,0,9,0,9
2021-03-21,West Coast,0,4,1,5
2021-03-21,Waitemata,0,298,4,302
2021-03-21,Wairarapa,0,8,0,8
2021-03-21,Waikato,0,193,2,195
2021-03-21,Taranaki,0,16,0,16
2021-03-21,Tairawhiti,0,4,0,4
2021-03-21,Southern,0,214,2,216
2021-03-21,South Canterbury,0,17,0,17
2021-03-21,Northland,0,29,0,29
2021-03-21,Nelson Marlborough,0,49,0,49
2021-03-21,Mid Central,0,32,0,32
2021-03-21,Lakes,0,16,0,16
2021-03-21,Hutt Valley,0,24,0,24
2021-03-21,Hawke's Bay,0,44,0,44
2021-03-21,Counties Manukau,0,231,1,232
2021-03-21,Capital and Coast,0,94,2,96
2021-03-21,Canterbury,0,156,12,168
2021-03-21,Bay of Plenty,0,48,0,48
2021-03-21,Managed Isolation & Quarantine,58,658,1,717
2021-03-21,Total,58,2369,26,2453
2021-03-22,Auckland,0,225,1,226
2021-03-22,Whanganui,0,9,0,9
2021-03-22,West Coast,0,4,1,5
2021-03-22,Waitemata,0,298,4,302
2021-03-22,Wairarapa,0,8,0,8
2021-03-22,Waikato,0,194,2,196
2021-03-22,Taranaki,0,16,0,16
2021-03-22,Tairawhiti,0,4,0,4
2021-03-22,Southern,0,214,2,216
2021-03-22,South Canterbury,0,17,0,17
2021-03-22,Northland,0,29,0,29
2021-03-22,Nelson Marlborough,0,49,0,49
2021-03-22,Mid Central,0,32,0,32
2021-03-22,Lakes,0,16,0,16
2021-03-22,Hutt Valley,0,24,0,24
2021-03-22,Hawke's Bay,0,44,0,44
2021-03-22,Counties Manukau,0,231,1,232
2021-03-22,Capital and Coast,0,94,2,96
2021-03-22,Canterbury,0,156,12,168
2021-03-22,Bay of Plenty,0,48,0,48
2021-03-22,Managed Isolation & Quarantine,63,661,1,725
2021-03-22,Total,63,2373,26,2462
2021-03-23,Auckland,0,225,1,226
2021-03-23,Whanganui,0,9,0,9
2021-03-23,West Coast,0,4,1,5
2021-03-23,Waitemata,0,298,4,302
2021-03-23,Wairarapa,0,8,0,8
2021-03-23,Waikato,0,194,2,196
2021-03-23,Taranaki,0,16,0,16
2021-03-23,Tairawhiti,0,4,0,4
2021-03-23,Southern,0,214,2,216
2021-03-23,South Canterbury,0,17,0,17
2021-03-23,Northland,0,29,0,29
2021-03-23,Nelson Marlborough,0,49,0,49
2021-03-23,Mid Central,0,32,0,32
2021-03-23,Lakes,0,16,0,16
2021-03-23,Hutt Valley,0,24,0,24
2021-03-23,Hawke's Bay,0,44,0,44
2021-03-23,Counties Manukau,0,231,1,232
2021-03-23,Capital and Coast,0,94,2,96
2021-03-23,Canterbury,0,156,12,168
2021-03-23,Bay of Plenty,0,48,0,48
2021-03-23,Managed Isolation & Quarantine,68,662,1,731
2021-03-23,Total,68,2374,26,2468
2021-03-24,Auckland,0,225,1,226
2021-03-24,Whanganui,0,9,0,9
2021-03-24,West Coast,0,4,1,5
2021-03-24,Waitemata,0,298,4,302
2021-03-24,Wairarapa,0,8,0,8
2021-03-24,Waikato,0,194,2,196
2021-03-24,Taranaki,0,16,0,16
2021-03-24,Tairawhiti,0,4,0,4
2021-03-24,Southern,0,214,2,216
2021-03-24,South Canterbury,0,17,0,17
2021-03-24,Northland,0,29,0,29
2021-03-24,Nelson Marlborough,0,49,0,49
2021-03-24,Mid Central,0,32,0,32
2021-03-24,Lakes,0,16,0,16
2021-03-24,Hutt Valley,0,24,0,24
2021-03-24,Hawke's Bay,0,44,0,44
2021-03-24,Counties Manukau,0,231,1,232
2021-03-24,Capital and Coast,0,94,2,96
2021-03-24,Canterbury,0,156,12,168
2021-03-24,Bay of Plenty,0,48,0,48
2021-03-24,Managed Isolation & Quarantine,67,665,1,733
2021-03-24,Total,67,2377,26,2470
2021-03-25,Auckland,0,225,1,226
2021-03-25,Whanganui,0,9,0,9
2021-03-25,West Coast,0,4,1,5
2021-03-25,Waitemata,0,298,4,302
2021-03-25,Wairarapa,0,8,0,8
2021-03-25,Waikato,0,194,2,196
2021-03-25,Taranaki,0,16,0,16
2021-03-25,Tairawhiti,0,4,0,4
2021-03-25,Southern,0,214,2,216
2021-03-25,South Canterbury,0,17,0,17
2021-03-25,Northland,0,29,0,29
2021-03-25,Nelson Marlborough,0,49,0,49
2021-03-25,Mid Central,0,32,0,32
2021-03-25,Lakes,0,16,0,16
2021-03-25,Hutt Valley,0,24,0,24
2021-03-25,Hawke's Bay,0,44,0,44
2021-03-25,Counties Manukau,0,231,1,232
2021-03-25,Capital and Coast,0,94,2,96
2021-03-25,Canterbury,0,156,12,168
2021-03-25,Bay of Plenty,0,48,0,48
2021-03-25,Managed Isolation & Quarantine,71,667,1,739
2021-03-25,Total,71,2379,26,2476
2021-03-26,Auckland,0,225,1,226
2021-03-26,Whanganui,0,9,0,9
2021-03-26,West Coast,0,4,1,5
2021-03-26,Waitemata,0,298,4,302
2021-03-26,Wairarapa,0,8,0,8
2021-03-26,Waikato,0,194,2,196
2021-03-26,Taranaki,0,16,0,16
2021-03-26,Tairawhiti,0,4,0,4
2021-03-26,Southern,0,214,2,216
2021-03-26,South Canterbury,0,17,0,17
2021-03-26,Northland,0,29,0,29
2021-03-26,Nelson Marlborough,0,49,0,49
2021-03-26,Mid Central,0,32,0,32
2021-03-26,Lakes,0,16,0,16
2021-03-26,Hutt Valley,0,24,0,24
2021-03-26,Hawke's Bay,0,44,0,44
2021-03-26,Counties Manukau,0,231,1,232
2021-03-26,Capital and Coast,0,94,2,96
2021-03-26,Canterbury,0,156,12,168
2021-03-26,Bay of Plenty,0,48,0,48
2021-03-26,Managed Isolation & Quarantine,74,667,1,742
2021-03-26,Total,74,2379,26,2479
2021-03-27,Auckland,0,225,1,226
2021-03-27,Whanganui,0,9,0,9
2021-03-27,West Coast,0,4,1,5
2021-03-27,Waitemata,0,298,4,302
2021-03-27,Wairarapa,0,8,0,8
2021-03-27,Waikato,0,194,2,196
2021-03-27,Taranaki,0,16,0,16
2021-03-27,Tairawhiti,0,4,0,4
2021-03-27,Southern,0,215,2,217
2021-03-27,South Canterbury,0,17,0,17
2021-03-27,Northland,0,29,0,29
2021-03-27,Nelson Marlborough,0,49,0,49
2021-03-27,Mid Central,0,32,0,32
2021-03-27,Lakes,0,16,0,16
2021-03-27,Hutt Valley,0,24,0,24
2021-03-27,Hawke's Bay,0,44,0,44
2021-03-27,Counties Manukau,0,231,1,232
2021-03-27,Capital and Coast,0,94,2,96
2021-03-27,Canterbury,0,156,12,168
2021-03-27,Bay of Plenty,0,48,0,48
2021-03-27,Managed Isolation & Quarantine,74,668,1,743
2021-03-27,Total,74,2381,26,2481
2021-03-28,Auckland,0,225,1,226
2021-03-28,Whanganui,0,9,0,9
2021-03-28,West Coast,0,4,1,5
2021-03-28,Waitemata,0,298,4,302
2021-03-28,Wairarapa,0,8,0,8
2021-03-28,Waikato,0,194,2,196
2021-03-28,Taranaki,0,16,0,16
2021-03-28,Tairawhiti,0,4,0,4
2021-03-28,Southern,0,215,2,217
2021-03-28,South Canterbury,0,17,0,17
2021-03-28,Northland,0,29,0,29
2021-03-28,Nelson Marlborough,0,49,0,49
2021-03-28,Mid Central,0,32,0,32
2021-03-28,Lakes,0,16,0,16
2021-03-28,Hutt Valley,0,24,0,24
2021-03-28,Hawke's Bay,0,44,0,44
2021-03-28,Counties Manukau,0,231,1,232
2021-03-28,Capital and Coast,0,94,2,96
2021-03-28,Canterbury,0,156,12,168
2021-03-28,Bay of Plenty,0,48,0,48
2021-03-28,Managed Isolation & Quarantine,75,668,1,744
2021-03-28,Total,75,2381,26,2482
2021-03-29,Auckland,0,225,1,226
2021-03-29,Whanganui,0,9,0,9
2021-03-29,West Coast,0,4,1,5
2021-03-29,Waitemata,0,298,4,302
2021-03-29,Wairarapa,0,8,0,8
2021-03-29,Waikato,0,194,2,196
2021-03-29,Taranaki,0,16,0,16
2021-03-29,Tairawhiti,0,4,0,4
2021-03-29,Southern,0,215,2,217
2021-03-29,South Canterbury,0,17,0,17
2021-03-29,Northland,0,29,0,29
2021-03-29,Nelson Marlborough,0,49,0,49
2021-03-29,Mid Central,0,32,0,32
2021-03-29,Lakes,0,16,0,16
2021-03-29,Hutt Valley,0,24,0,24
2021-03-29,Hawke's Bay,0,44,0,44
2021-03-29,Counties Manukau,0,231,1,232
2021-03-29,Capital and Coast,0,94,2,96
2021-03-29,Canterbury,0,156,12,168
2021-03-29,Bay of Plenty,0,48,0,48
2021-03-29,Managed Isolation & Quarantine,86,668,1,755
2021-03-29,Total,86,2381,26,2493
2021-03-30,Auckland,0,225,1,226
2021-03-30,Whanganui,0,9,0,9
2021-03-30,West Coast,0,4,1,5
2021-03-30,Waitemata,0,296,4,300
2021-03-30,Wairarapa,0,8,0,8
2021-03-30,Waikato,0,194,2,196
2021-03-30,Taranaki,0,16,0,16
2021-03-30,Tairawhiti,0,4,0,4
2021-03-30,Southern,0,215,2,217
2021-03-30,South Canterbury,0,17,0,17
2021-03-30,Northland,0,28,0,28
2021-03-30,Nelson Marlborough,0,49,0,49
2021-03-30,Mid Central,0,32,0,32
2021-03-30,Lakes,0,16,0,16
2021-03-30,Hutt Valley,0,24,0,24
2021-03-30,Hawke's Bay,0,44,0,44
2021-03-30,Counties Manukau,0,231,1,232
2021-03-30,Capital and Coast,0,94,2,96
2021-03-30,Canterbury,0,156,12,168
2021-03-30,Bay of Plenty,0,48,0,48
2021-03-30,Managed Isolation & Quarantine,80,679,1,760
2021-03-30,Total,80,2389,26,2495
2021-03-31,Auckland,0,225,1,226
2021-03-31,Whanganui,0,9,0,9
2021-03-31,West Coast,0,4,1,5
2021-03-31,Waitemata,0,296,4,300
2021-03-31,Wairarapa,0,8,0,8
2021-03-31,Waikato,0,194,2,196
2021-03-31,Taranaki,0,16,0,16
2021-03-31,Tairawhiti,0,4,0,4
2021-03-31,Southern,0,215,2,217
2021-03-31,South Canterbury,0,17,0,17
2021-03-31,Northland,0,28,0,28
2021-03-31,Nelson Marlborough,0,49,0,49
2021-03-31,Mid Central,0,32,0,32
2021-03-31,Lakes,0,16,0,16
2021-03-31,Hutt Valley,0,24,0,24
2021-03-31,Hawke's Bay,0,44,0,44
2021-03-31,Counties Manukau,0,231,1,232
2021-03-31,Capital and Coast,0,94,2,96
2021-03-31,Canterbury,0,156,12,168
2021-03-31,Bay of Plenty,0,48,0,48
2021-03-31,Managed Isolation & Quarantine,72,689,1,762
2021-03-31,Total,72,2399,26,2497
2021-04-01,Auckland,0,225,1,226
2021-04-01,Whanganui,0,9,0,9
2021-04-01,West Coast,0,4,1,5
2021-04-01,Waitemata,0,296,4,300
2021-04-01,Wairarapa,0,8,0,8
2021-04-01,Waikato,0,194,2,196
2021-04-01,Taranaki,0,16,0,16
2021-04-01,Tairawhiti,0,4,0,4
2021-04-01,Southern,0,215,2,217
2021-04-01,South Canterbury,0,17,0,17
2021-04-01,Northland,0,28,0,28
2021-04-01,Nelson Marlborough,0,49,0,49
2021-04-01,Mid Central,0,32,0,32
2021-04-01,Lakes,0,16,0,16
2021-04-01,Hutt Valley,0,24,0,24
2021-04-01,Hawke's Bay,0,44,0,44
2021-04-01,Counties Manukau,0,231,1,232
2021-04-01,Capital and Coast,0,94,2,96
2021-04-01,Canterbury,0,156,12,168
2021-04-01,Bay of Plenty,0,48,0,48
2021-04-01,Managed Isolation & Quarantine,67,698,1,766
2021-04-01,Total,67,2408,26,2501
2021-04-04,Auckland,0,225,1,226
2021-04-04,Whanganui,0,9,0,9
2021-04-04,West Coast,0,4,1,5
2021-04-04,Waitemata,0,296,4,300
2021-04-04,Wairarapa,0,8,0,8
2021-04-04,Waikato,0,194,2,196
2021-04-04,Taranaki,0,16,0,16
2021-04-04,Tairawhiti,0,4,0,4
2021-04-04,Southern,0,215,2,217
2021-04-04,South Canterbury,0,17,0,17
2021-04-04,Northland,0,28,0,28
2021-04-04,Nelson Marlborough,0,49,0,49
2021-04-04,Mid Central,0,32,0,32
2021-04-04,Lakes,0,16,0,16
2021-04-04,Hutt Valley,0,24,0,24
2021-04-04,Hawke's Bay,0,44,0,44
2021-04-04,Counties Manukau,0,231,1,232
2021-04-04,Capital and Coast,0,94,2,96
2021-04-04,Canterbury,0,156,12,168
2021-04-04,Bay of Plenty,0,48,0,48
2021-04-04,Managed Isolation & Quarantine,61,710,1,772
2021-04-04,Total,61,2420,26,2507
2021-04-06,Auckland,0,225,1,226
2021-04-06,Whanganui,0,9,0,9
2021-04-06,West Coast,0,4,1,5
2021-04-06,Waitemata,0,296,4,300
2021-04-06,Wairarapa,0,8,0,8
2021-04-06,Waikato,0,194,2,196
2021-04-06,Taranaki,0,16,0,16
2021-04-06,Tairawhiti,0,4,0,4
2021-04-06,Southern,0,215,2,217
2021-04-06,South Canterbury,0,17,0,17
2021-04-06,Northland,0,28,0,28
2021-04-06,Nelson Marlborough,0,49,0,49
2021-04-06,Mid Central,0,32,0,32
2021-04-06,Lakes,0,16,0,16
2021-04-06,Hutt Valley,0,24,0,24
2021-04-06,Hawke's Bay,0,44,0,44
2021-04-06,Counties Manukau,0,231,1,232
2021-04-06,Capital and Coast,0,94,2,96
2021-04-06,Canterbury,0,156,12,168
2021-04-06,Bay of Plenty,0,48,0,48
2021-04-06,Managed Isolation & Quarantine,74,714,1,789
2021-04-06,Total,74,2424,26,2524
2021-04-07,Auckland,0,225,1,226
2021-04-07,Whanganui,0,9,0,9
2021-04-07,West Coast,0,4,1,5
2021-04-07,Waitemata,0,296,4,300
2021-04-07,Wairarapa,0,8,0,8
2021-04-07,Waikato,0,194,2,196
2021-04-07,Taranaki,0,16,0,16
2021-04-07,Tairawhiti,0,4,0,4
2021-04-07,Southern,0,215,2,217
2021-04-07,South Canterbury,0,17,0,17
2021-04-07,Northland,0,28,0,28
2021-04-07,Nelson Marlborough,0,49,0,49
2021-04-07,Mid Central,0,32,0,32
2021-04-07,Lakes,0,16,0,16
2021-04-07,Hutt Valley,0,24,0,24
2021-04-07,Hawke's Bay,0,44,0,44
2021-04-07,Counties Manukau,0,231,1,232
2021-04-07,Capital and Coast,0,94,2,96
2021-04-07,Canterbury,0,156,12,168
2021-04-07,Bay of Plenty,0,48,0,48
2021-04-07,Managed Isolation & Quarantine,81,714,1,796
2021-04-07,Total,81,2424,26,2531
2021-04-08,Auckland,0,225,1,226
2021-04-08,Whanganui,0,9,0,9
2021-04-08,West Coast,0,4,1,5
2021-04-08,Waitemata,0,296,4,300
2021-04-08,Wairarapa,0,8,0,8
2021-04-08,Waikato,0,194,2,196
2021-04-08,Taranaki,0,16,0,16
2021-04-08,Tairawhiti,0,4,0,4
2021-04-08,Southern,0,215,2,217
2021-04-08,South Canterbury,0,17,0,17
2021-04-08,Northland,0,28,0,28
2021-04-08,Nelson Marlborough,0,49,0,49
2021-04-08,Mid Central,0,32,0,32
2021-04-08,Lakes,0,16,0,16
2021-04-08,Hutt Valley,0,24,0,24
2021-04-08,Hawke's Bay,0,44,0,44
2021-04-08,Counties Manukau,0,231,1,232
2021-04-08,Capital and Coast,0,94,2,96
2021-04-08,Canterbury,0,156,12,168
2021-04-08,Bay of Plenty,0,48,0,48
2021-04-08,Managed Isolation & Quarantine,95,724,1,820
2021-04-08,Total,95,2434,26,2555
2021-04-09,Auckland,0,225,1,226
2021-04-09,Whanganui,0,9,0,9
2021-04-09,West Coast,0,4,1,5
2021-04-09,Waitemata,0,296,4,300
2021-04-09,Wairarapa,0,8,0,8
2021-04-09,Waikato,0,194,2,196
2021-04-09,Taranaki,0,16,0,16
2021-04-09,Tairawhiti,0,4,0,4
2021-04-09,Southern,0,215,2,217
2021-04-09,South Canterbury,0,17,0,17
2021-04-09,Northland,0,28,0,28
2021-04-09,Nelson Marlborough,0,49,0,49
2021-04-09,Mid Central,0,32,0,32
2021-04-09,Lakes,0,16,0,16
2021-04-09,Hutt Valley,0,24,0,24
2021-04-09,Hawke's Bay,0,44,0,44
2021-04-09,Counties Manukau,0,231,1,232
2021-04-09,Capital and Coast,0,94,2,96
2021-04-09,Canterbury,0,156,12,168
2021-04-09,Bay of Plenty,0,48,0,48
2021-04-09,Managed Isolation & Quarantine,95,730,1,826
2021-04-09,Total,95,2440,26,2561
2021-04-10,Auckland,0,225,1,226
2021-04-10,Whanganui,0,9,0,9
2021-04-10,West Coast,0,4,1,5
2021-04-10,Waitemata,0,296,4,300
2021-04-10,Wairarapa,0,8,0,8
2021-04-10,Waikato,0,193,2,195
2021-04-10,Taranaki,0,16,0,16
2021-04-10,Tairawhiti,0,4,0,4
2021-04-10,Southern,0,215,2,217
2021-04-10,South Canterbury,0,17,0,17
2021-04-10,Northland,0,28,0,28
2021-04-10,Nelson Marlborough,0,49,0,49
2021-04-10,Mid Central,0,32,0,32
2021-04-10,Lakes,0,16,0,16
2021-04-10,Hutt Valley,0,24,0,24
2021-04-10,Hawke's Bay,0,44,0,44
2021-04-10,Counties Manukau,0,231,1,232
2021-04-10,Capital and Coast,0,94,2,96
2021-04-10,Canterbury,0,156,12,168
2021-04-10,Bay of Plenty,0,48,0,48
2021-04-10,Managed Isolation & Quarantine,105,731,1,837
2021-04-10,Total,105,2440,26,2571
2021-04-11,Auckland,0,225,1,226
2021-04-11,Whanganui,0,9,0,9
2021-04-11,West Coast,0,4,1,5
2021-04-11,Waitemata,0,296,4,300
2021-04-11,Wairarapa,0,8,0,8
2021-04-11,Waikato,0,193,2,195
2021-04-11,Taranaki,0,16,0,16
2021-04-11,Tairawhiti,0,4,0,4
2021-04-11,Southern,0,215,2,217
2021-04-11,South Canterbury,0,17,0,17
2021-04-11,Northland,0,28,0,28
2021-04-11,Nelson Marlborough,0,49,0,49
2021-04-11,Mid Central,0,32,0,32
2021-04-11,Lakes,0,16,0,16
2021-04-11,Hutt Valley,0,24,0,24
2021-04-11,Hawke's Bay,0,44,0,44
2021-04-11,Counties Manukau,0,231,1,232
2021-04-11,Capital and Coast,0,94,2,96
2021-04-11,Canterbury,0,156,12,168
2021-04-11,Bay of Plenty,0,48,0,48
2021-04-11,Managed Isolation & Quarantine,108,731,1,840
2021-04-11,Total,108,2440,26,2574
2021-04-12,Auckland,0,225,1,226
2021-04-12,Whanganui,0,9,0,9
2021-04-12,West Coast,0,4,1,5
2021-04-12,Waitemata,0,296,4,300
2021-04-12,Wairarapa,0,8,0,8
2021-04-12,Waikato,0,193,2,195
2021-04-12,Taranaki,0,16,0,16
2021-04-12,Tairawhiti,0,4,0,4
2021-04-12,Southern,0,215,2,217
2021-04-12,South Canterbury,0,17,0,17
2021-04-12,Northland,0,28,0,28
2021-04-12,Nelson Marlborough,0,49,0,49
2021-04-12,Mid Central,0,33,0,33
2021-04-12,Lakes,0,16,0,16
2021-04-12,Hutt Valley,0,24,0,24
2021-04-12,Hawke's Bay,0,44,0,44
2021-04-12,Counties Manukau,0,231,1,232
2021-04-12,Capital and Coast,0,94,2,96
2021-04-12,Canterbury,0,156,12,168
2021-04-12,Bay of Plenty,0,48,0,48
2021-04-12,Managed Isolation & Quarantine,100,747,1,848
2021-04-12,Total,100,2457,26,2583
2021-04-13,Auckland,0,225,1,226
2021-04-13,Whanganui,0,9,0,9
2021-04-13,West Coast,0,4,1,5
2021-04-13,Waitemata,0,296,4,300
2021-04-13,Wairarapa,0,8,0,8
2021-04-13,Waikato,0,193,2,195
2021-04-13,Taranaki,0,16,0,16
2021-04-13,Tairawhiti,0,4,0,4
2021-04-13,Southern,0,215,2,217
2021-04-13,South Canterbury,0,17,0,17
2021-04-13,Northland,0,28,0,28
2021-04-13,Nelson Marlborough,0,49,0,49
2021-04-13,Mid Central,0,33,0,33
2021-04-13,Lakes,0,16,0,16
2021-04-13,Hutt Valley,0,24,0,24
2021-04-13,Hawke's Bay,0,44,0,44
2021-04-13,Counties Manukau,0,231,1,232
2021-04-13,Capital and Coast,0,94,2,96
2021-04-13,Canterbury,0,156,12,168
2021-04-13,Bay of Plenty,0,48,0,48
2021-04-13,Managed Isolation & Quarantine,102,749,1,852
2021-04-13,Total,102,2459,26,2587
2021-04-14,Auckland,0,225,1,226
2021-04-14,Whanganui,0,9,0,9
2021-04-14,West Coast,0,4,1,5
2021-04-14,Waitemata,0,296,4,300
2021-04-14,Wairarapa,0,8,0,8
2021-04-14,Waikato,0,193,2,195
2021-04-14,Taranaki,0,16,0,16
2021-04-14,Tairawhiti,0,4,0,4
2021-04-14,Southern,0,215,2,217
2021-04-14,South Canterbury,0,17,0,17
2021-04-14,Northland,0,28,0,28
2021-04-14,Nelson Marlborough,0,49,0,49
2021-04-14,Mid Central,0,33,0,33
2021-04-14,Lakes,0,16,0,16
2021-04-14,Hutt Valley,0,24,0,24
2021-04-14,Hawke's Bay,0,44,0,44
2021-04-14,Counties Manukau,0,231,1,232
2021-04-14,Capital and Coast,0,94,2,96
2021-04-14,Canterbury,0,156,12,168
2021-04-14,Bay of Plenty,0,48,0,48
2021-04-14,Managed Isolation & Quarantine,101,752,1,854
2021-04-14,Total,101,2462,26,2589
2021-04-15,Auckland,0,225,1,226
2021-04-15,Whanganui,0,9,0,9
2021-04-15,West Coast,0,4,1,5
2021-04-15,Waitemata,0,296,4,300
2021-04-15,Wairarapa,0,8,0,8
2021-04-15,Waikato,0,193,2,195
2021-04-15,Taranaki,0,16,0,16
2021-04-15,Tairawhiti,0,4,0,4
2021-04-15,Southern,0,215,2,217
2021-04-15,South Canterbury,0,17,0,17
2021-04-15,Northland,0,28,0,28
2021-04-15,Nelson Marlborough,0,49,0,49
2021-04-15,Mid Central,0,33,0,33
2021-04-15,Lakes,0,16,0,16
2021-04-15,Hutt Valley,0,24,0,24
2021-04-15,Hawke's Bay,0,44,0,44
2021-04-15,Counties Manukau,0,231,1,232
2021-04-15,Capital and Coast,0,94,2,96
2021-04-15,Canterbury,0,156,12,168
2021-04-15,Bay of Plenty,0,48,0,48
2021-04-15,Managed Isolation & Quarantine,101,754,1,856
2021-04-15,Total,101,2464,26,2591
2021-04-16,Auckland,0,225,1,226
2021-04-16,Whanganui,0,9,0,9
2021-04-16,West Coast,0,4,1,5
2021-04-16,Waitemata,0,296,4,300
2021-04-16,Wairarapa,0,8,0,8
2021-04-16,Waikato,0,193,2,195
2021-04-16,Taranaki,0,16,0,16
2021-04-16,Tairawhiti,0,4,0,4
2021-04-16,Southern,0,215,2,217
2021-04-16,South Canterbury,0,17,0,17
2021-04-16,Northland,0,28,0,28
2021-04-16,Nelson Marlborough,0,49,0,49
2021-04-16,Mid Central,0,33,0,33
2021-04-16,Lakes,0,16,0,16
2021-04-16,Hutt Valley,0,24,0,24
2021-04-16,Hawke's Bay,0,44,0,44
2021-04-16,Counties Manukau,0,231,1,232
2021-04-16,Capital and Coast,0,94,2,96
2021-04-16,Canterbury,0,156,12,168
2021-04-16,Bay of Plenty,0,48,0,48
2021-04-16,Managed Isolation & Quarantine,100,754,1,855
2021-04-16,Total,100,2464,26,2590
2021-04-18,Auckland,0,225,1,226
2021-04-18,Whanganui,0,9,0,9
2021-04-18,West Coast,0,4,1,5
2021-04-18,Waitemata,0,296,4,300
2021-04-18,Wairarapa,0,8,0,8
2021-04-18,Waikato,0,193,2,195
2021-04-18,Taranaki,0,16,0,16
2021-04-18,Tairawhiti,0,4,0,4
2021-04-18,Southern,0,215,2,217
2021-04-18,South Canterbury,0,17,0,17
2021-04-18,Northland,0,28,0,28
2021-04-18,Nelson Marlborough,0,49,0,49
2021-04-18,Mid Central,0,33,0,33
2021-04-18,Lakes,0,16,0,16
2021-04-18,Hutt Valley,0,24,0,24
2021-04-18,Hawke's Bay,0,44,0,44
2021-04-18,Counties Manukau,0,231,1,232
2021-04-18,Capital and Coast,0,94,2,96
2021-04-18,Canterbury,0,156,12,168
2021-04-18,Bay of Plenty,0,48,0,48
2021-04-18,Managed Isolation & Quarantine,102,757,1,860
2021-04-18,Total,102,2467,26,2595
2021-04-19,Auckland,0,225,1,226
2021-04-19,Whanganui,0,9,0,9
2021-04-19,West Coast,0,4,1,5
2021-04-19,Waitemata,0,296,4,300
2021-04-19,Wairarapa,0,8,0,8
2021-04-19,Waikato,0,193,2,195
2021-04-19,Taranaki,0,16,0,16
2021-04-19,Tairawhiti,0,4,0,4
2021-04-19,Southern,0,215,2,217
2021-04-19,South Canterbury,0,17,0,17
2021-04-19,Northland,0,28,0,28
2021-04-19,Nelson Marlborough,0,49,0,49
2021-04-19,Mid Central,0,33,0,33
2021-04-19,Lakes,0,16,0,16
2021-04-19,Hutt Valley,0,24,0,24
2021-04-19,Hawke's Bay,0,44,0,44
2021-04-19,Counties Manukau,0,231,1,232
2021-04-19,Capital and Coast,0,94,2,96
2021-04-19,Canterbury,0,156,12,168
2021-04-19,Bay of Plenty,0,48,0,48
2021-04-19,Managed Isolation & Quarantine,102,758,1,861
2021-04-19,Total,102,2468,26,2596
2021-04-20,Auckland,0,225,1,226
2021-04-20,Whanganui,0,9,0,9
2021-04-20,West Coast,0,4,1,5
2021-04-20,Waitemata,0,296,4,300
2021-04-20,Wairarapa,0,8,0,8
2021-04-20,Waikato,0,193,2,195
2021-04-20,Taranaki,0,16,0,16
2021-04-20,Tairawhiti,0,4,0,4
2021-04-20,Southern,0,215,2,217
2021-04-20,South Canterbury,0,17,0,17
2021-04-20,Northland,0,28,0,28
2021-04-20,Nelson Marlborough,0,49,0,49
2021-04-20,Mid Central,0,33,0,33
2021-04-20,Lakes,0,16,0,16
2021-04-20,Hutt Valley,0,24,0,24
2021-04-20,Hawke's Bay,0,44,0,44
2021-04-20,Counties Manukau,0,231,1,232
2021-04-20,Capital and Coast,0,94,2,96
2021-04-20,Canterbury,0,156,12,168
2021-04-20,Bay of Plenty,0,48,0,48
2021-04-20,Managed Isolation & Quarantine,86,775,1,862
2021-04-20,Total,86,2485,26,2597
2021-04-21,Auckland,0,225,1,226
2021-04-21,Whanganui,0,9,0,9
2021-04-21,West Coast,0,4,1,5
2021-04-21,Waitemata,0,296,4,300
2021-04-21,Wairarapa,0,8,0,8
2021-04-21,Waikato,0,193,2,195
2021-04-21,Taranaki,0,16,0,16
2021-04-21,Tairawhiti,0,4,0,4
2021-04-21,Southern,0,215,2,217
2021-04-21,South Canterbury,0,17,0,17
2021-04-21,Northland,0,28,0,28
2021-04-21,Nelson Marlborough,0,49,0,49
2021-04-21,Mid Central,0,33,0,33
2021-04-21,Lakes,0,16,0,16
2021-04-21,Hutt Valley,0,24,0,24
2021-04-21,Hawke's Bay,0,44,0,44
2021-04-21,Counties Manukau,0,231,1,232
2021-04-21,Capital and Coast,0,94,2,96
2021-04-21,Canterbury,0,156,12,168
2021-04-21,Bay of Plenty,0,48,0,48
2021-04-21,Managed Isolation & Quarantine,83,780,1,864
2021-04-21,Total,83,2490,26,2599
2021-04-22,Auckland,0,225,1,226
2021-04-22,Whanganui,0,9,0,9
2021-04-22,West Coast,0,4,1,5
2021-04-22,Waitemata,0,296,4,300
2021-04-22,Wairarapa,0,8,0,8
2021-04-22,Waikato,0,193,2,195
2021-04-22,Taranaki,0,16,0,16
2021-04-22,Tairawhiti,0,4,0,4
2021-04-22,Southern,0,215,2,217
2021-04-22,South Canterbury,0,17,0,17
2021-04-22,Northland,0,28,0,28
2021-04-22,Nelson Marlborough,0,49,0,49
2021-04-22,Mid Central,0,33,0,33
2021-04-22,Lakes,0,16,0,16
2021-04-22,Hutt Valley,0,24,0,24
2021-04-22,Hawke's Bay,0,44,0,44
2021-04-22,Counties Manukau,0,231,1,232
2021-04-22,Capital and Coast,0,94,2,96
2021-04-22,Canterbury,0,156,12,168
2021-04-22,Bay of Plenty,0,48,0,48
2021-04-22,Managed Isolation & Quarantine,80,784,1,865
2021-04-22,Total,80,2494,26,2600
2021-04-23,Auckland,0,225,1,226
2021-04-23,Whanganui,0,9,0,9
2021-04-23,West Coast,0,4,1,5
2021-04-23,Waitemata,0,296,4,300
2021-04-23,Wairarapa,0,8,0,8
2021-04-23,Waikato,0,193,2,195
2021-04-23,Taranaki,0,16,0,16
2021-04-23,Tairawhiti,0,4,0,4
2021-04-23,Southern,0,215,2,217
2021-04-23,South Canterbury,0,17,0,17
2021-04-23,Northland,0,28,0,28
2021-04-23,Nelson Marlborough,0,49,0,49
2021-04-23,Mid Central,0,33,0,33
2021-04-23,Lakes,0,16,0,16
2021-04-23,Hutt Valley,0,24,0,24
2021-04-23,Hawke's Bay,0,44,0,44
2021-04-23,Counties Manukau,0,231,1,232
2021-04-23,Capital and Coast,0,94,2,96
2021-04-23,Canterbury,0,156,12,168
2021-04-23,Bay of Plenty,0,48,0,48
2021-04-23,Managed Isolation & Quarantine,32,832,1,865
2021-04-23,Total,32,2542,26,2600
2021-04-24,Auckland,0,225,1,226
2021-04-24,Whanganui,0,9,0,9
2021-04-24,West Coast,0,4,1,5
2021-04-24,Waitemata,0,296,4,300
2021-04-24,Wairarapa,0,8,0,8
2021-04-24,Waikato,0,193,2,195
2021-04-24,Taranaki,0,16,0,16
2021-04-24,Tairawhiti,0,4,0,4
2021-04-24,Southern,0,215,2,217
2021-04-24,South Canterbury,0,17,0,17
2021-04-24,Northland,0,28,0,28
2021-04-24,Nelson Marlborough,0,49,0,49
2021-04-24,Mid Central,0,33,0,33
2021-04-24,Lakes,0,16,0,16
2021-04-24,Hutt Valley,0,24,0,24
2021-04-24,Hawke's Bay,0,44,0,44
2021-04-24,Counties Manukau,0,231,1,232
2021-04-24,Capital and Coast,0,94,2,96
2021-04-24,Canterbury,0,156,12,168
2021-04-24,Bay of Plenty,0,48,0,48
2021-04-24,Managed Isolation & Quarantine,33,832,1,866
2021-04-24,Total,33,2542,26,2601
2021-04-25,Auckland,0,225,1,226
2021-04-25,Whanganui,0,9,0,9
2021-04-25,West Coast,0,4,1,5
2021-04-25,Waitemata,0,296,4,300
2021-04-25,Wairarapa,0,8,0,8
2021-04-25,Waikato,0,193,2,195
2021-04-25,Taranaki,0,16,0,16
2021-04-25,Tairawhiti,0,4,0,4
2021-04-25,Southern,0,215,2,217
2021-04-25,South Canterbury,0,17,0,17
2021-04-25,Northland,0,28,0,28
2021-04-25,Nelson Marlborough,0,49,0,49
2021-04-25,Mid Central,0,33,0,33
2021-04-25,Lakes,0,16,0,16
2021-04-25,Hutt Valley,0,24,0,24
2021-04-25,Hawke's Bay,0,44,0,44
2021-04-25,Counties Manukau,0,231,1,232
2021-04-25,Capital and Coast,0,94,2,96
2021-04-25,Canterbury,0,156,12,168
2021-04-25,Bay of Plenty,0,48,0,48
2021-04-25,Managed Isolation & Quarantine,33,832,1,866
2021-04-25,Total,33,2542,26,2601
2021-04-27,Auckland,0,225,1,226
2021-04-27,Whanganui,0,9,0,9
2021-04-27,West Coast,0,4,1,5
2021-04-27,Waitemata,0,296,4,300
2021-04-27,Wairarapa,0,8,0,8
2021-04-27,Waikato,0,193,2,195
2021-04-27,Taranaki,0,16,0,16
2021-04-27,Tairawhiti,0,4,0,4
2021-04-27,Southern,0,215,2,217
2021-04-27,South Canterbury,0,17,0,17
2021-04-27,Northland,0,28,0,28
2021-04-27,Nelson Marlborough,0,49,0,49
2021-04-27,Mid Central,0,33,0,33
2021-04-27,Lakes,0,16,0,16
2021-04-27,Hutt Valley,0,24,0,24
2021-04-27,Hawke's Bay,0,44,0,44
2021-04-27,Counties Manukau,0,231,1,232
2021-04-27,Capital and Coast,0,94,2,96
2021-04-27,Canterbury,0,156,12,168
2021-04-27,Bay of Plenty,0,48,0,48
2021-04-27,Managed Isolation & Quarantine,36,837,1,874
2021-04-27,Total,36,2547,26,2609
2021-04-28,Auckland,0,225,1,226
2021-04-28,Whanganui,0,9,0,9
2021-04-28,West Coast,0,4,1,5
2021-04-28,Waitemata,0,296,4,300
2021-04-28,Wairarapa,0,8,0,8
2021-04-28,Waikato,0,193,2,195
2021-04-28,Taranaki,0,16,0,16
2021-04-28,Tairawhiti,0,4,0,4
2021-04-28,Southern,0,215,2,217
2021-04-28,South Canterbury,0,17,0,17
2021-04-28,Northland,0,28,0,28
2021-04-28,Nelson Marlborough,0,49,0,49
2021-04-28,Mid Central,0,33,0,33
2021-04-28,Lakes,0,16,0,16
2021-04-28,Hutt Valley,0,24,0,24
2021-04-28,Hawke's Bay,0,44,0,44
2021-04-28,Counties Manukau,0,231,1,232
2021-04-28,Capital and Coast,0,94,2,96
2021-04-28,Canterbury,0,156,12,168
2021-04-28,Bay of Plenty,0,48,0,48
2021-04-28,Managed Isolation & Quarantine,27,847,1,875
2021-04-28,Total,27,2557,26,2610
2021-04-29,Auckland,0,225,1,226
2021-04-29,Whanganui,0,9,0,9
2021-04-29,West Coast,0,4,1,5
2021-04-29,Waitemata,0,296,4,300
2021-04-29,Wairarapa,0,8,0,8
2021-04-29,Waikato,0,193,2,195
2021-04-29,Taranaki,0,16,0,16
2021-04-29,Tairawhiti,0,4,0,4
2021-04-29,Southern,0,215,2,217
2021-04-29,South Canterbury,0,17,0,17
2021-04-29,Northland,0,28,0,28
2021-04-29,Nelson Marlborough,0,49,0,49
2021-04-29,Mid Central,0,33,0,33
2021-04-29,Lakes,0,16,0,16
2021-04-29,Hutt Valley,0,24,0,24
2021-04-29,Hawke's Bay,0,44,0,44
2021-04-29,Counties Manukau,0,231,1,232
2021-04-29,Capital and Coast,0,94,2,96
2021-04-29,Canterbury,0,156,12,168
2021-04-29,Bay of Plenty,0,48,0,48
2021-04-29,Managed Isolation & Quarantine,23,854,1,878
2021-04-29,Total,23,2564,26,2613
2021-04-30,Auckland,0,225,1,226
2021-04-30,Whanganui,0,9,0,9
2021-04-30,West Coast,0,4,1,5
2021-04-30,Waitemata,0,296,4,300
2021-04-30,Wairarapa,0,8,0,8
2021-04-30,Waikato,0,193,2,195
2021-04-30,Taranaki,0,16,0,16
2021-04-30,Tairawhiti,0,4,0,4
2021-04-30,Southern,0,215,2,217
2021-04-30,South Canterbury,0,17,0,17
2021-04-30,Northland,0,28,0,28
2021-04-30,Nelson Marlborough,0,49,0,49
2021-04-30,Mid Central,0,33,0,33
2021-04-30,Lakes,0,16,0,16
2021-04-30,Hutt Valley,0,24,0,24
2021-04-30,Hawke's Bay,0,44,0,44
2021-04-30,Counties Manukau,0,231,1,232
2021-04-30,Capital and Coast,0,94,2,96
2021-04-30,Canterbury,0,156,12,168
2021-04-30,Bay of Plenty,0,48,0,48
2021-04-30,Managed Isolation & Quarantine,23,854,1,878
2021-04-30,Total,23,2564,26,2613
2021-05-02,Auckland,0,225,1,226
2021-05-02,Whanganui,0,9,0,9
2021-05-02,West Coast,0,4,1,5
2021-05-02,Waitemata,0,296,4,300
2021-05-02,Wairarapa,0,8,0,8
2021-05-02,Waikato,0,193,2,195
2021-05-02,Taranaki,0,16,0,16
2021-05-02,Tairawhiti,0,4,0,4
2021-05-02,Southern,0,215,2,217
2021-05-02,South Canterbury,0,17,0,17
2021-05-02,Northland,0,28,0,28
2021-05-02,Nelson Marlborough,0,49,0,49
2021-05-02,Mid Central,0,33,0,33
2021-05-02,Lakes,0,16,0,16
2021-05-02,Hutt Valley,0,24,0,24
2021-05-02,Hawke's Bay,0,44,0,44
2021-05-02,Counties Manukau,0,231,1,232
2021-05-02,Capital and Coast,0,94,2,96
2021-05-02,Canterbury,0,156,12,168
2021-05-02,Bay of Plenty,0,48,0,48
2021-05-02,Managed Isolation & Quarantine,24,858,1,883
2021-05-02,Total,24,2568,26,2618
2021-05-03,Auckland,0,225,1,226
2021-05-03,Whanganui,0,9,0,9
2021-05-03,West Coast,0,4,1,5
2021-05-03,Waitemata,0,296,4,300
2021-05-03,Wairarapa,0,8,0,8
2021-05-03,Waikato,0,193,2,195
2021-05-03,Taranaki,0,16,0,16
2021-05-03,Tairawhiti,0,4,0,4
2021-05-03,Southern,0,215,2,217
2021-05-03,South Canterbury,0,17,0,17
2021-05-03,Northland,0,28,0,28
2021-05-03,Nelson Marlborough,0,49,0,49
2021-05-03,Mid Central,0,33,0,33
2021-05-03,Lakes,0,16,0,16
2021-05-03,Hutt Valley,0,24,0,24
2021-05-03,Hawke's Bay,0,44,0,44
2021-05-03,Counties Manukau,0,231,1,232
2021-05-03,Capital and Coast,0,94,2,96
2021-05-03,Canterbury,0,156,12,168
2021-05-03,Bay of Plenty,0,48,0,48
2021-05-03,Managed Isolation & Quarantine,25,861,1,887
2021-05-03,Total,25,2571,26,2622
2021-05-04,Auckland,0,225,1,226
2021-05-04,Whanganui,0,9,0,9
2021-05-04,West Coast,0,4,1,5
2021-05-04,Waitemata,0,296,4,300
2021-05-04,Wairarapa,0,8,0,8
2021-05-04,Waikato,0,193,2,195
2021-05-04,Taranaki,0,16,0,16
2021-05-04,Tairawhiti,0,4,0,4
2021-05-04,Southern,0,215,2,217
2021-05-04,South Canterbury,0,17,0,17
2021-05-04,Northland,0,28,0,28
2021-05-04,Nelson Marlborough,0,49,0,49
2021-05-04,Mid Central,0,33,0,33
2021-05-04,Lakes,0,16,0,16
2021-05-04,Hutt Valley,0,24,0,24
2021-05-04,Hawke's Bay,0,44,0,44
2021-05-04,Counties Manukau,0,231,1,232
2021-05-04,Capital and Coast,0,94,2,96
2021-05-04,Canterbury,0,156,12,168
2021-05-04,Bay of Plenty,0,48,0,48
2021-05-04,Managed Isolation & Quarantine,24,863,1,888
2021-05-04,Total,24,2573,26,2623
2021-05-05,Auckland,0,225,1,226
2021-05-05,Whanganui,0,9,0,9
2021-05-05,West Coast,0,4,1,5
2021-05-05,Waitemata,0,296,4,300
2021-05-05,Wairarapa,0,8,0,8
2021-05-05,Waikato,0,193,2,195
2021-05-05,Taranaki,0,16,0,16
2021-05-05,Tairawhiti,0,4,0,4
2021-05-05,Southern,0,215,2,217
2021-05-05,South Canterbury,0,17,0,17
2021-05-05,Northland,0,28,0,28
2021-05-05,Nelson Marlborough,0,49,0,49
2021-05-05,Mid Central,0,33,0,33
2021-05-05,Lakes,0,16,0,16
2021-05-05,Hutt Valley,0,24,0,24
2021-05-05,Hawke's Bay,0,44,0,44
2021-05-05,Counties Manukau,0,231,1,232
2021-05-05,Capital and Coast,0,94,2,96
2021-05-05,Canterbury,0,156,12,168
2021-05-05,Bay of Plenty,0,48,0,48
2021-05-05,Managed Isolation & Quarantine,25,868,1,894
2021-05-05,Total,25,2578,26,2629
2021-05-06,Auckland,0,225,1,226
2021-05-06,Whanganui,0,9,0,9
2021-05-06,West Coast,0,4,1,5
2021-05-06,Waitemata,0,296,4,300
2021-05-06,Wairarapa,0,8,0,8
2021-05-06,Waikato,0,193,2,195
2021-05-06,Taranaki,0,16,0,16
2021-05-06,Tairawhiti,0,4,0,4
2021-05-06,Southern,0,215,2,217
2021-05-06,South Canterbury,0,17,0,17
2021-05-06,Northland,0,28,0,28
2021-05-06,Nelson Marlborough,0,49,0,49
2021-05-06,Mid Central,0,33,0,33
2021-05-06,Lakes,0,16,0,16
2021-05-06,Hutt Valley,0,24,0,24
2021-05-06,Hawke's Bay,0,44,0,44
2021-05-06,Counties Manukau,0,231,1,232
2021-05-06,Capital and Coast,0,94,2,96
2021-05-06,Canterbury,0,156,12,168
2021-05-06,Bay of Plenty,0,48,0,48
2021-05-06,Managed Isolation & Quarantine,28,869,1,898
2021-05-06,Total,28,2579,26,2633
2021-05-07,Auckland,0,225,1,226
2021-05-07,Whanganui,0,9,0,9
2021-05-07,West Coast,0,4,1,5
2021-05-07,Waitemata,0,296,4,300
2021-05-07,Wairarapa,0,8,0,8
2021-05-07,Waikato,0,193,2,195
2021-05-07,Taranaki,0,16,0,16
2021-05-07,Tairawhiti,0,4,0,4
2021-05-07,Southern,0,215,2,217
2021-05-07,South Canterbury,0,17,0,17
2021-05-07,Northland,0,28,0,28
2021-05-07,Nelson Marlborough,0,49,0,49
2021-05-07,Mid Central,0,33,0,33
2021-05-07,Lakes,0,16,0,16
2021-05-07,Hutt Valley,0,24,0,24
2021-05-07,Hawke's Bay,0,44,0,44
2021-05-07,Counties Manukau,0,231,1,232
2021-05-07,Capital and Coast,0,94,2,96
2021-05-07,Canterbury,0,156,12,168
2021-05-07,Bay of Plenty,0,48,0,48
2021-05-07,Managed Isolation & Quarantine,26,872,1,899
2021-05-07,Total,26,2582,26,2634
2021-05-08,Auckland,0,225,1,226
2021-05-08,Whanganui,0,9,0,9
2021-05-08,West Coast,0,4,1,5
2021-05-08,Waitemata,0,296,4,300
2021-05-08,Wairarapa,0,8,0,8
2021-05-08,Waikato,0,193,2,195
2021-05-08,Taranaki,0,16,0,16
2021-05-08,Tairawhiti,0,4,0,4
2021-05-08,Southern,0,215,2,217
2021-05-08,South Canterbury,0,17,0,17
2021-05-08,Northland,0,28,0,28
2021-05-08,Nelson Marlborough,0,49,0,49
2021-05-08,Mid Central,0,33,0,33
2021-05-08,Lakes,0,16,0,16
2021-05-08,Hutt Valley,0,24,0,24
2021-05-08,Hawke's Bay,0,44,0,44
2021-05-08,Counties Manukau,0,231,1,232
2021-05-08,Capital and Coast,0,94,2,96
2021-05-08,Canterbury,0,156,12,168
2021-05-08,Bay of Plenty,0,48,0,48
2021-05-08,Managed Isolation & Quarantine,25,879,1,905
2021-05-08,Total,25,2589,26,2640
2021-05-09,Auckland,0,225,1,226
2021-05-09,Whanganui,0,9,0,9
2021-05-09,West Coast,0,4,1,5
2021-05-09,Waitemata,0,296,4,300
2021-05-09,Wairarapa,0,8,0,8
2021-05-09,Waikato,0,193,2,195
2021-05-09,Taranaki,0,16,0,16
2021-05-09,Tairawhiti,0,4,0,4
2021-05-09,Southern,0,215,2,217
2021-05-09,South Canterbury,0,17,0,17
2021-05-09,Northland,0,28,0,28
2021-05-09,Nelson Marlborough,0,49,0,49
2021-05-09,Mid Central,0,33,0,33
2021-05-09,Lakes,0,16,0,16
2021-05-09,Hutt Valley,0,24,0,24
2021-05-09,Hawke's Bay,0,44,0,44
2021-05-09,Counties Manukau,0,231,1,232
2021-05-09,Capital and Coast,0,94,2,96
2021-05-09,Canterbury,0,156,12,168
2021-05-09,Bay of Plenty,0,48,0,48
2021-05-09,Managed Isolation & Quarantine,27,879,1,907
2021-05-09,Total,27,2589,26,2642
2021-05-10,Auckland,0,225,1,226
2021-05-10,Whanganui,0,9,0,9
2021-05-10,West Coast,0,4,1,5
2021-05-10,Waitemata,0,296,4,300
2021-05-10,Wairarapa,0,8,0,8
2021-05-10,Waikato,0,193,2,195
2021-05-10,Taranaki,0,16,0,16
2021-05-10,Tairawhiti,0,4,0,4
2021-05-10,Southern,0,215,2,217
2021-05-10,South Canterbury,0,17,0,17
2021-05-10,Northland,0,28,0,28
2021-05-10,Nelson Marlborough,0,49,0,49
2021-05-10,Mid Central,0,33,0,33
2021-05-10,Lakes,0,16,0,16
2021-05-10,Hutt Valley,0,24,0,24
2021-05-10,Hawke's Bay,0,44,0,44
2021-05-10,Counties Manukau,0,231,1,232
2021-05-10,Capital and Coast,0,94,2,96
2021-05-10,Canterbury,0,156,12,168
2021-05-10,Bay of Plenty,0,48,0,48
2021-05-10,Managed Isolation & Quarantine,27,881,1,909
2021-05-10,Total,27,2591,26,2644
2021-05-11,Auckland,0,225,1,226
2021-05-11,Whanganui,0,9,0,9
2021-05-11,West Coast,0,4,1,5
2021-05-11,Waitemata,0,296,4,300
2021-05-11,Wairarapa,0,8,0,8
2021-05-11,Waikato,0,193,2,195
2021-05-11,Taranaki,0,16,0,16
2021-05-11,Tairawhiti,0,4,0,4
2021-05-11,Southern,0,215,2,217
2021-05-11,South Canterbury,0,17,0,17
2021-05-11,Northland,0,28,0,28
2021-05-11,Nelson Marlborough,0,49,0,49
2021-05-11,Mid Central,0,33,0,33
2021-05-11,Lakes,0,16,0,16
2021-05-11,Hutt Valley,0,24,0,24
2021-05-11,Hawke's Bay,0,44,0,44
2021-05-11,Counties Manukau,0,231,1,232
2021-05-11,Capital and Coast,0,94,2,96
2021-05-11,Canterbury,0,156,12,168
2021-05-11,Bay of Plenty,0,48,0,48
2021-05-11,Managed Isolation & Quarantine,24,883,1,908
2021-05-11,Total,24,2593,26,2643
2021-05-12,Auckland,0,225,1,226
2021-05-12,Whanganui,0,9,0,9
2021-05-12,West Coast,0,4,1,5
2021-05-12,Waitemata,0,296,4,300
2021-05-12,Wairarapa,0,8,0,8
2021-05-12,Waikato,0,193,2,195
2021-05-12,Taranaki,0,16,0,16
2021-05-12,Tairawhiti,0,4,0,4
2021-05-12,Southern,0,215,2,217
2021-05-12,South Canterbury,0,17,0,17
2021-05-12,Northland,0,28,0,28
2021-05-12,Nelson Marlborough,0,49,0,49
2021-05-12,Mid Central,0,33,0,33
2021-05-12,Lakes,0,16,0,16
2021-05-12,Hutt Valley,0,24,0,24
2021-05-12,Hawke's Bay,0,44,0,44
2021-05-12,Counties Manukau,0,231,1,232
2021-05-12,Capital and Coast,0,94,2,96
2021-05-12,Canterbury,0,156,12,168
2021-05-12,Bay of Plenty,0,48,0,48
2021-05-12,Managed Isolation & Quarantine,22,885,1,908
2021-05-12,Total,22,2595,26,2643
2021-05-13,Auckland,0,225,1,226
2021-05-13,Whanganui,0,9,0,9
2021-05-13,West Coast,0,4,1,5
2021-05-13,Waitemata,0,296,4,300
2021-05-13,Wairarapa,0,8,0,8
2021-05-13,Waikato,0,193,2,195
2021-05-13,Taranaki,0,16,0,16
2021-05-13,Tairawhiti,0,4,0,4
2021-05-13,Southern,0,215,2,217
2021-05-13,South Canterbury,0,17,0,17
2021-05-13,Northland,0,28,0,28
2021-05-13,Nelson Marlborough,0,49,0,49
2021-05-13,Mid Central,0,33,0,33
2021-05-13,Lakes,0,16,0,16
2021-05-13,Hutt Valley,0,24,0,24
2021-05-13,Hawke's Bay,0,44,0,44
2021-05-13,Counties Manukau,0,231,1,232
2021-05-13,Capital and Coast,0,94,2,96
2021-05-13,Canterbury,0,156,12,168
2021-05-13,Bay of Plenty,0,48,0,48
2021-05-13,Managed Isolation & Quarantine,18,890,1,909
2021-05-13,Total,18,2600,26,2644
2021-05-14,Auckland,0,225,1,226
2021-05-14,Whanganui,0,9,0,9
2021-05-14,West Coast,0,4,1,5
2021-05-14,Waitemata,0,296,4,300
2021-05-14,Wairarapa,0,8,0,8
2021-05-14,Waikato,0,193,2,195
2021-05-14,Taranaki,0,16,0,16
2021-05-14,Tairawhiti,0,4,0,4
2021-05-14,Southern,0,215,2,217
2021-05-14,South Canterbury,0,17,0,17
2021-05-14,Northland,0,28,0,28
2021-05-14,Nelson Marlborough,0,49,0,49
2021-05-14,Mid Central,0,33,0,33
2021-05-14,Lakes,0,16,0,16
2021-05-14,Hutt Valley,0,24,0,24
2021-05-14,Hawke's Bay,0,44,0,44
2021-05-14,Counties Manukau,0,231,1,232
2021-05-14,Capital and Coast,0,94,2,96
2021-05-14,Canterbury,0,156,12,168
2021-05-14,Bay of Plenty,0,48,0,48
2021-05-14,Managed Isolation & Quarantine,18,891,1,910
2021-05-14,Total,18,2601,26,2645
2021-05-16,Auckland,0,225,1,226
2021-05-16,Whanganui,0,9,0,9
2021-05-16,West Coast,0,4,1,5
2021-05-16,Waitemata,0,296,4,300
2021-05-16,Wairarapa,0,8,0,8
2021-05-16,Waikato,0,193,2,195
2021-05-16,Taranaki,0,16,0,16
2021-05-16,Tairawhiti,0,4,0,4
2021-05-16,Southern,0,215,2,217
2021-05-16,South Canterbury,0,17,0,17
2021-05-16,Northland,0,28,0,28
2021-05-16,Nelson Marlborough,0,49,0,49
2021-05-16,Mid Central,0,33,0,33
2021-05-16,Lakes,0,16,0,16
2021-05-16,Hutt Valley,0,24,0,24
2021-05-16,Hawke's Bay,0,44,0,44
2021-05-16,Counties Manukau,0,231,1,232
2021-05-16,Capital and Coast,0,94,2,96
2021-05-16,Canterbury,0,156,12,168
2021-05-16,Bay of Plenty,0,48,0,48
2021-05-16,Managed Isolation & Quarantine,19,891,1,911
2021-05-16,Total,19,2601,26,2646
2021-05-17,Auckland,0,225,1,226
2021-05-17,Whanganui,0,9,0,9
2021-05-17,West Coast,0,4,1,5
2021-05-17,Waitemata,0,296,4,300
2021-05-17,Wairarapa,0,8,0,8
2021-05-17,Waikato,0,193,2,195
2021-05-17,Taranaki,0,16,0,16
2021-05-17,Tairawhiti,0,4,0,4
2021-05-17,Southern,0,215,2,217
2021-05-17,South Canterbury,0,17,0,17
2021-05-17,Northland,0,28,0,28
2021-05-17,Nelson Marlborough,0,49,0,49
2021-05-17,Mid Central,0,33,0,33
2021-05-17,Lakes,0,16,0,16
2021-05-17,Hutt Valley,0,24,0,24
2021-05-17,Hawke's Bay,0,44,0,44
2021-05-17,Counties Manukau,0,231,1,232
2021-05-17,Capital and Coast,0,94,2,96
2021-05-17,Canterbury,0,156,12,168
2021-05-17,Bay of Plenty,0,48,0,48
2021-05-17,Managed Isolation & Quarantine,18,897,1,916
2021-05-17,Total,18,2607,26,2651
2021-05-18,Auckland,0,225,1,226
2021-05-18,Whanganui,0,9,0,9
2021-05-18,West Coast,0,4,1,5
2021-05-18,Waitemata,0,296,4,300
2021-05-18,Wairarapa,0,8,0,8
2021-05-18,Waikato,0,193,2,195
2021-05-18,Taranaki,0,16,0,16
2021-05-18,Tairawhiti,0,4,0,4
2021-05-18,Southern,0,215,2,217
2021-05-18,South Canterbury,0,17,0,17
2021-05-18,Northland,0,28,0,28
2021-05-18,Nelson Marlborough,0,49,0,49
2021-05-18,Mid Central,0,33,0,33
2021-05-18,Lakes,0,16,0,16
2021-05-18,Hutt Valley,0,24,0,24
2021-05-18,Hawke's Bay,0,44,0,44
2021-05-18,Counties Manukau,0,231,1,232
2021-05-18,Capital and Coast,0,94,2,96
2021-05-18,Canterbury,0,156,12,168
2021-05-18,Bay of Plenty,0,48,0,48
2021-05-18,Managed Isolation & Quarantine,19,898,1,918
2021-05-18,Total,19,2608,26,2653
2021-05-19,Auckland,0,225,1,226
2021-05-19,Whanganui,0,9,0,9
2021-05-19,West Coast,0,4,1,5
2021-05-19,Waitemata,0,296,4,300
2021-05-19,Wairarapa,0,8,0,8
2021-05-19,Waikato,0,193,2,195
2021-05-19,Taranaki,0,16,0,16
2021-05-19,Tairawhiti,0,4,0,4
2021-05-19,Southern,0,215,2,217
2021-05-19,South Canterbury,0,17,0,17
2021-05-19,Northland,0,28,0,28
2021-05-19,Nelson Marlborough,0,49,0,49
2021-05-19,Mid Central,0,33,0,33
2021-05-19,Lakes,0,16,0,16
2021-05-19,Hutt Valley,0,24,0,24
2021-05-19,Hawke's Bay,0,44,0,44
2021-05-19,Counties Manukau,0,231,1,232
2021-05-19,Capital and Coast,0,94,2,96
2021-05-19,Canterbury,0,156,12,168
2021-05-19,Bay of Plenty,0,48,0,48
2021-05-19,Managed Isolation & Quarantine,25,897,1,923
2021-05-19,Total,25,2607,26,2658
2021-05-20,Auckland,0,225,1,226
2021-05-20,Whanganui,0,9,0,9
2021-05-20,West Coast,0,4,1,5
2021-05-20,Waitemata,0,296,4,300
2021-05-20,Wairarapa,0,8,0,8
2021-05-20,Waikato,0,193,2,195
2021-05-20,Taranaki,0,16,0,16
2021-05-20,Tairawhiti,0,4,0,4
2021-05-20,Southern,0,215,2,217
2021-05-20,South Canterbury,0,17,0,17
2021-05-20,Northland,0,28,0,28
2021-05-20,Nelson Marlborough,0,49,0,49
2021-05-20,Mid Central,0,33,0,33
2021-05-20,Lakes,0,16,0,16
2021-05-20,Hutt Valley,0,24,0,24
2021-05-20,Hawke's Bay,0,44,0,44
2021-05-20,Counties Manukau,0,231,1,232
2021-05-20,Capital and Coast,0,94,2,96
2021-05-20,Canterbury,0,156,12,168
2021-05-20,Bay of Plenty,0,48,0,48
2021-05-20,Managed Isolation & Quarantine,24,899,1,924
2021-05-20,Total,24,2609,26,2659
2021-05-21,Auckland,0,225,1,226
2021-05-21,Whanganui,0,9,0,9
2021-05-21,West Coast,0,4,1,5
2021-05-21,Waitemata,0,296,4,300
2021-05-21,Wairarapa,0,8,0,8
2021-05-21,Waikato,0,193,2,195
2021-05-21,Taranaki,0,16,0,16
2021-05-21,Tairawhiti,0,4,0,4
2021-05-21,Southern,0,215,2,217
2021-05-21,South Canterbury,0,17,0,17
2021-05-21,Northland,0,28,0,28
2021-05-21,Nelson Marlborough,0,49,0,49
2021-05-21,Mid Central,0,33,0,33
2021-05-21,Lakes,0,16,0,16
2021-05-21,Hutt Valley,0,24,0,24
2021-05-21,Hawke's Bay,0,44,0,44
2021-05-21,Counties Manukau,0,231,1,232
2021-05-21,Capital and Coast,0,94,2,96
2021-05-21,Canterbury,0,156,12,168
2021-05-21,Bay of Plenty,0,48,0,48
2021-05-21,Managed Isolation & Quarantine,23,903,1,927
2021-05-21,Total,23,2613,26,2662
2021-05-23,Auckland,0,225,1,226
2021-05-23,Whanganui,0,9,0,9
2021-05-23,West Coast,0,4,1,5
2021-05-23,Waitemata,0,296,4,300
2021-05-23,Wairarapa,0,8,0,8
2021-05-23,Waikato,0,193,2,195
2021-05-23,Taranaki,0,16,0,16
2021-05-23,Tairawhiti,0,4,0,4
2021-05-23,Southern,0,215,2,217
2021-05-23,South Canterbury,0,17,0,17
2021-05-23,Northland,0,28,0,28
2021-05-23,Nelson Marlborough,0,49,0,49
2021-05-23,Mid Central,0,33,0,33
2021-05-23,Lakes,0,16,0,16
2021-05-23,Hutt Valley,0,24,0,24
2021-05-23,Hawke's Bay,0,44,0,44
2021-05-23,Counties Manukau,0,231,1,232
2021-05-23,Capital and Coast,0,94,2,96
2021-05-23,Canterbury,0,156,12,168
2021-05-23,Bay of Plenty,0,48,0,48
2021-05-23,Managed Isolation & Quarantine,27,905,1,933
2021-05-23,Total,27,2615,26,2668
2021-05-24,Auckland,0,225,1,226
2021-05-24,Whanganui,0,9,0,9
2021-05-24,West Coast,0,4,1,5
2021-05-24,Waitemata,0,296,4,300
2021-05-24,Wairarapa,0,8,0,8
2021-05-24,Waikato,0,193,2,195
2021-05-24,Taranaki,0,16,0,16
2021-05-24,Tairawhiti,0,4,0,4
2021-05-24,Southern,0,215,2,217
2021-05-24,South Canterbury,0,17,0,17
2021-05-24,Northland,0,28,0,28
2021-05-24,Nelson Marlborough,0,49,0,49
2021-05-24,Mid Central,0,33,0,33
2021-05-24,Lakes,0,16,0,16
2021-05-24,Hutt Valley,0,24,0,24
2021-05-24,Hawke's Bay,0,44,0,44
2021-05-24,Counties Manukau,0,231,1,232
2021-05-24,Capital and Coast,0,94,2,96
2021-05-24,Canterbury,0,156,12,168
2021-05-24,Bay of Plenty,0,48,0,48
2021-05-24,Managed Isolation & Quarantine,24,907,1,932
2021-05-24,Total,24,2617,26,2667
2021-05-25,Auckland,0,225,1,226
2021-05-25,Whanganui,0,9,0,9
2021-05-25,West Coast,0,4,1,5
2021-05-25,Waitemata,0,296,4,300
2021-05-25,Wairarapa,0,8,0,8
2021-05-25,Waikato,0,193,2,195
2021-05-25,Taranaki,0,16,0,16
2021-05-25,Tairawhiti,0,4,0,4
2021-05-25,Southern,0,215,2,217
2021-05-25,South Canterbury,0,17,0,17
2021-05-25,Northland,0,28,0,28
2021-05-25,Nelson Marlborough,0,49,0,49
2021-05-25,Mid Central,0,33,0,33
2021-05-25,Lakes,0,16,0,16
2021-05-25,Hutt Valley,0,24,0,24
2021-05-25,Hawke's Bay,0,44,0,44
2021-05-25,Counties Manukau,0,231,1,232
2021-05-25,Capital and Coast,0,94,2,96
2021-05-25,Canterbury,0,156,12,168
2021-05-25,Bay of Plenty,0,48,0,48
2021-05-25,Managed Isolation & Quarantine,22,911,1,934
2021-05-25,Total,22,2621,26,2669
2021-05-26,Auckland,0,225,1,226
2021-05-26,Whanganui,0,9,0,9
2021-05-26,West Coast,0,4,1,5
2021-05-26,Waitemata,0,296,4,300
2021-05-26,Wairarapa,0,8,0,8
2021-05-26,Waikato,0,193,2,195
2021-05-26,Taranaki,0,16,0,16
2021-05-26,Tairawhiti,0,4,0,4
2021-05-26,Southern,0,215,2,217
2021-05-26,South Canterbury,0,17,0,17
2021-05-26,Northland,0,28,0,28
2021-05-26,Nelson Marlborough,0,49,0,49
2021-05-26,Mid Central,0,33,0,33
2021-05-26,Lakes,0,16,0,16
2021-05-26,Hutt Valley,0,24,0,24
2021-05-26,Hawke's Bay,0,44,0,44
2021-05-26,Counties Manukau,0,231,1,232
2021-05-26,Capital and Coast,0,94,2,96
2021-05-26,Canterbury,0,156,12,168
2021-05-26,Bay of Plenty,0,48,0,48
2021-05-26,Managed Isolation & Quarantine,22,911,1,934
2021-05-26,Total,22,2621,26,2669
2021-05-27,Auckland,0,225,1,226
2021-05-27,Whanganui,0,9,0,9
2021-05-27,West Coast,0,4,1,5
2021-05-27,Waitemata,0,296,4,300
2021-05-27,Wairarapa,0,8,0,8
2021-05-27,Waikato,0,193,2,195
2021-05-27,Taranaki,0,16,0,16
2021-05-27,Tairawhiti,0,4,0,4
2021-05-27,Southern,0,215,2,217
2021-05-27,South Canterbury,0,17,0,17
2021-05-27,Northland,0,28,0,28
2021-05-27,Nelson Marlborough,0,49,0,49
2021-05-27,Mid Central,0,33,0,33
2021-05-27,Lakes,0,16,0,16
2021-05-27,Hutt Valley,0,24,0,24
2021-05-27,Hawke's Bay,0,44,0,44
2021-05-27,Counties Manukau,0,231,1,232
2021-05-27,Capital and Coast,0,94,2,96
2021-05-27,Canterbury,0,156,12,168
2021-05-27,Bay of Plenty,0,48,0,48
2021-05-27,Managed Isolation & Quarantine,21,913,1,935
2021-05-27,Total,21,2623,26,2670
2021-05-28,Auckland,0,225,1,226
2021-05-28,Whanganui,0,9,0,9
2021-05-28,West Coast,0,4,1,5
2021-05-28,Waitemata,0,296,4,300
2021-05-28,Wairarapa,0,8,0,8
2021-05-28,Waikato,0,193,2,195
2021-05-28,Taranaki,0,16,0,16
2021-05-28,Tairawhiti,0,4,0,4
2021-05-28,Southern,0,215,2,217
2021-05-28,South Canterbury,0,17,0,17
2021-05-28,Northland,0,28,0,28
2021-05-28,Nelson Marlborough,0,49,0,49
2021-05-28,Mid Central,0,33,0,33
2021-05-28,Lakes,0,16,0,16
2021-05-28,Hutt Valley,0,24,0,24
2021-05-28,Hawke's Bay,0,44,0,44
2021-05-28,Counties Manukau,0,231,1,232
2021-05-28,Capital and Coast,0,94,2,96
2021-05-28,Canterbury,0,156,12,168
2021-05-28,Bay of Plenty,0,48,0,48
2021-05-28,Managed Isolation & Quarantine,21,913,1,935
2021-05-28,Total,21,2623,26,2670
2021-05-30,Auckland,0,225,1,226
2021-05-30,Whanganui,0,9,0,9
2021-05-30,West Coast,0,4,1,5
2021-05-30,Waitemata,0,296,4,300
2021-05-30,Wairarapa,0,8,0,8
2021-05-30,Waikato,0,193,2,195
2021-05-30,Taranaki,0,16,0,16
2021-05-30,Tairawhiti,0,4,0,4
2021-05-30,Southern,0,215,2,217
2021-05-30,South Canterbury,0,17,0,17
2021-05-30,Northland,0,28,0,28
2021-05-30,Nelson Marlborough,0,49,0,49
2021-05-30,Mid Central,0,33,0,33
2021-05-30,Lakes,0,16,0,16
2021-05-30,Hutt Valley,0,24,0,24
2021-05-30,Hawke's Bay,0,44,0,44
2021-05-30,Counties Manukau,0,231,1,232
2021-05-30,Capital and Coast,0,94,2,96
2021-05-30,Canterbury,0,156,12,168
2021-05-30,Bay of Plenty,0,48,0,48
2021-05-30,Managed Isolation & Quarantine,16,920,1,937
2021-05-30,Total,16,2630,26,2672
2021-05-31,Auckland,0,225,1,226
2021-05-31,Whanganui,0,9,0,9
2021-05-31,West Coast,0,4,1,5
2021-05-31,Waitemata,0,296,4,300
2021-05-31,Wairarapa,0,8,0,8
2021-05-31,Waikato,0,193,2,195
2021-05-31,Taranaki,0,16,0,16
2021-05-31,Tairawhiti,0,4,0,4
2021-05-31,Southern,0,215,2,217
2021-05-31,South Canterbury,0,17,0,17
2021-05-31,Northland,0,28,0,28
2021-05-31,Nelson Marlborough,0,49,0,49
2021-05-31,Mid Central,0,33,0,33
2021-05-31,Lakes,0,16,0,16
2021-05-31,Hutt Valley,0,24,0,24
2021-05-31,Hawke's Bay,0,44,0,44
2021-05-31,Counties Manukau,0,231,1,232
2021-05-31,Capital and Coast,0,94,2,96
2021-05-31,Canterbury,0,156,12,168
2021-05-31,Bay of Plenty,0,48,0,48
2021-05-31,Managed Isolation & Quarantine,17,920,1,938
2021-05-31,Total,17,2630,26,2673
2021-06-01,Auckland,0,225,1,226
2021-06-01,Whanganui,0,9,0,9
2021-06-01,West Coast,0,4,1,5
2021-06-01,Waitemata,0,296,4,300
2021-06-01,Wairarapa,0,8,0,8
2021-06-01,Waikato,0,193,2,195
2021-06-01,Taranaki,0,16,0,16
2021-06-01,Tairawhiti,0,4,0,4
2021-06-01,Southern,0,215,2,217
2021-06-01,South Canterbury,0,17,0,17
2021-06-01,Northland,0,28,0,28
2021-06-01,Nelson Marlborough,0,49,0,49
2021-06-01,Mid Central,0,33,0,33
2021-06-01,Lakes,0,16,0,16
2021-06-01,Hutt Valley,0,24,0,24
2021-06-01,Hawke's Bay,0,44,0,44
2021-06-01,Counties Manukau,0,231,1,232
2021-06-01,Capital and Coast,0,94,2,96
2021-06-01,Canterbury,0,156,12,168
2021-06-01,Bay of Plenty,0,48,0,48
2021-06-01,Managed Isolation & Quarantine,13,924,1,938
2021-06-01,Total,13,2634,26,2673
2021-06-02,Auckland,0,225,1,226
2021-06-02,Whanganui,0,9,0,9
2021-06-02,West Coast,0,4,1,5
2021-06-02,Waitemata,0,296,4,300
2021-06-02,Wairarapa,0,8,0,8
2021-06-02,Waikato,0,193,2,195
2021-06-02,Taranaki,0,16,0,16
2021-06-02,Tairawhiti,0,4,0,4
2021-06-02,Southern,0,215,2,217
2021-06-02,South Canterbury,0,17,0,17
2021-06-02,Northland,0,28,0,28
2021-06-02,Nelson Marlborough,0,49,0,49
2021-06-02,Mid Central,0,33,0,33
2021-06-02,Lakes,0,16,0,16
2021-06-02,Hutt Valley,0,24,0,24
2021-06-02,Hawke's Bay,0,44,0,44
2021-06-02,Counties Manukau,0,231,1,232
2021-06-02,Capital and Coast,0,94,2,96
2021-06-02,Canterbury,0,156,12,168
2021-06-02,Bay of Plenty,0,48,0,48
2021-06-02,Managed Isolation & Quarantine,18,925,1,944
2021-06-02,Total,18,2635,26,2679
2021-06-03,Auckland,0,225,1,226
2021-06-03,Whanganui,0,9,0,9
2021-06-03,West Coast,0,4,1,5
2021-06-03,Waitemata,0,296,4,300
2021-06-03,Wairarapa,0,8,0,8
2021-06-03,Waikato,0,193,2,195
2021-06-03,Taranaki,0,16,0,16
2021-06-03,Tairawhiti,0,4,0,4
2021-06-03,Southern,0,215,2,217
2021-06-03,South Canterbury,0,17,0,17
2021-06-03,Northland,0,28,0,28
2021-06-03,Nelson Marlborough,0,49,0,49
2021-06-03,Mid Central,0,33,0,33
2021-06-03,Lakes,0,16,0,16
2021-06-03,Hutt Valley,0,24,0,24
2021-06-03,Hawke's Bay,0,44,0,44
2021-06-03,Counties Manukau,0,231,1,232
2021-06-03,Capital and Coast,0,94,2,96
2021-06-03,Canterbury,0,156,12,168
2021-06-03,Bay of Plenty,0,48,0,48
2021-06-03,Managed Isolation & Quarantine,17,928,1,946
2021-06-03,Total,17,2638,26,2681
2021-06-04,Auckland,0,225,1,226
2021-06-04,Whanganui,0,9,0,9
2021-06-04,West Coast,0,4,1,5
2021-06-04,Waitemata,0,296,4,300
2021-06-04,Wairarapa,0,8,0,8
2021-06-04,Waikato,0,193,2,195
2021-06-04,Taranaki,0,16,0,16
2021-06-04,Tairawhiti,0,4,0,4
2021-06-04,Southern,0,215,2,217
2021-06-04,South Canterbury,0,17,0,17
2021-06-04,Northland,0,28,0,28
2021-06-04,Nelson Marlborough,0,49,0,49
2021-06-04,Mid Central,0,33,0,33
2021-06-04,Lakes,0,16,0,16
2021-06-04,Hutt Valley,0,24,0,24
2021-06-04,Hawke's Bay,0,44,0,44
2021-06-04,Counties Manukau,0,231,1,232
2021-06-04,Capital and Coast,0,94,2,96
2021-06-04,Canterbury,0,156,12,168
2021-06-04,Bay of Plenty,0,48,0,48
2021-06-04,Managed Isolation & Quarantine,17,929,1,947
2021-06-04,Total,17,2639,26,2682
2021-06-06,Auckland,0,225,1,226
2021-06-06,Whanganui,0,9,0,9
2021-06-06,West Coast,0,4,1,5
2021-06-06,Waitemata,0,296,4,300
2021-06-06,Wairarapa,0,8,0,8
2021-06-06,Waikato,0,193,2,195
2021-06-06,Taranaki,0,16,0,16
2021-06-06,Tairawhiti,0,4,0,4
2021-06-06,Southern,0,215,2,217
2021-06-06,South Canterbury,0,17,0,17
2021-06-06,Northland,0,28,0,28
2021-06-06,Nelson Marlborough,0,49,0,49
2021-06-06,Mid Central,0,33,0,33
2021-06-06,Lakes,0,16,0,16
2021-06-06,Hutt Valley,0,24,0,24
2021-06-06,Hawke's Bay,0,44,0,44
2021-06-06,Counties Manukau,0,231,1,232
2021-06-06,Capital and Coast,0,94,2,96
2021-06-06,Canterbury,0,156,12,168
2021-06-06,Bay of Plenty,0,48,0,48
2021-06-06,Managed Isolation & Quarantine,17,929,1,947
2021-06-06,Total,17,2639,26,2682
2021-06-08,Auckland,0,225,1,226
2021-06-08,Whanganui,0,9,0,9
2021-06-08,West Coast,0,4,1,5
2021-06-08,Waitemata,0,296,4,300
2021-06-08,Wairarapa,0,8,0,8
2021-06-08,Waikato,0,193,2,195
2021-06-08,Taranaki,0,16,0,16
2021-06-08,Tairawhiti,0,4,0,4
2021-06-08,Southern,0,215,2,217
2021-06-08,South Canterbury,0,17,0,17
2021-06-08,Northland,0,28,0,28
2021-06-08,Nelson Marlborough,0,49,0,49
2021-06-08,Mid Central,0,33,0,33
2021-06-08,Lakes,0,16,0,16
2021-06-08,Hutt Valley,0,24,0,24
2021-06-08,Hawke's Bay,0,44,0,44
2021-06-08,Counties Manukau,0,231,1,232
2021-06-08,Capital and Coast,0,94,2,96
2021-06-08,Canterbury,0,156,12,168
2021-06-08,Bay of Plenty,0,48,0,48
2021-06-08,Managed Isolation & Quarantine,22,934,1,957
2021-06-08,Total,22,2644,26,2692
2021-06-09,Auckland,0,225,1,226
2021-06-09,Whanganui,0,9,0,9
2021-06-09,West Coast,0,4,1,5
2021-06-09,Waitemata,0,296,4,300
2021-06-09,Wairarapa,0,8,0,8
2021-06-09,Waikato,0,193,2,195
2021-06-09,Taranaki,0,16,0,16
2021-06-09,Tairawhiti,0,4,0,4
2021-06-09,Southern,0,215,2,217
2021-06-09,South Canterbury,0,17,0,17
2021-06-09,Northland,0,28,0,28
2021-06-09,Nelson Marlborough,0,49,0,49
2021-06-09,Mid Central,0,33,0,33
2021-06-09,Lakes,0,16,0,16
2021-06-09,Hutt Valley,0,24,0,24
2021-06-09,Hawke's Bay,0,44,0,44
2021-06-09,Counties Manukau,0,231,1,232
2021-06-09,Capital and Coast,0,94,2,96
2021-06-09,Canterbury,0,156,12,168
2021-06-09,Bay of Plenty,0,48,0,48
2021-06-09,Managed Isolation & Quarantine,24,936,1,961
2021-06-09,Total,24,2646,26,2696
2021-06-10,Auckland,0,225,1,226
2021-06-10,Whanganui,0,9,0,9
2021-06-10,West Coast,0,4,1,5
2021-06-10,Waitemata,0,296,4,300
2021-06-10,Wairarapa,0,8,0,8
2021-06-10,Waikato,0,193,2,195
2021-06-10,Taranaki,0,16,0,16
2021-06-10,Tairawhiti,0,4,0,4
2021-06-10,Southern,0,215,2,217
2021-06-10,South Canterbury,0,17,0,17
2021-06-10,Northland,0,28,0,28
2021-06-10,Nelson Marlborough,0,49,0,49
2021-06-10,Mid Central,0,33,0,33
2021-06-10,Lakes,0,16,0,16
2021-06-10,Hutt Valley,0,24,0,24
2021-06-10,Hawke's Bay,0,44,0,44
2021-06-10,Counties Manukau,0,231,1,232
2021-06-10,Capital and Coast,0,94,2,96
2021-06-10,Canterbury,0,156,12,168
2021-06-10,Bay of Plenty,0,48,0,48
2021-06-10,Managed Isolation & Quarantine,24,937,1,962
2021-06-10,Total,24,2647,26,2697
2021-06-11,Auckland,0,225,1,226
2021-06-11,Whanganui,0,9,0,9
2021-06-11,West Coast,0,4,1,5
2021-06-11,Waitemata,0,296,4,300
2021-06-11,Wairarapa,0,8,0,8
2021-06-11,Waikato,0,193,2,195
2021-06-11,Taranaki,0,16,0,16
2021-06-11,Tairawhiti,0,4,0,4
2021-06-11,Southern,0,215,2,217
2021-06-11,South Canterbury,0,17,0,17
2021-06-11,Northland,0,28,0,28
2021-06-11,Nelson Marlborough,0,49,0,49
2021-06-11,Mid Central,0,33,0,33
2021-06-11,Lakes,0,16,0,16
2021-06-11,Hutt Valley,0,24,0,24
2021-06-11,Hawke's Bay,0,44,0,44
2021-06-11,Counties Manukau,0,231,1,232
2021-06-11,Capital and Coast,0,94,2,96
2021-06-11,Canterbury,0,156,12,168
2021-06-11,Bay of Plenty,0,48,0,48
2021-06-11,Managed Isolation & Quarantine,29,937,1,967
2021-06-11,Total,29,2647,26,2702
2021-06-13,Auckland,0,225,1,226
2021-06-13,Whanganui,0,9,0,9
2021-06-13,West Coast,0,4,1,5
2021-06-13,Waitemata,0,296,4,300
2021-06-13,Wairarapa,0,8,0,8
2021-06-13,Waikato,0,193,2,195
2021-06-13,Taranaki,0,16,0,16
2021-06-13,Tairawhiti,0,4,0,4
2021-06-13,Southern,0,215,2,217
2021-06-13,South Canterbury,0,17,0,17
2021-06-13,Northland,0,28,0,28
2021-06-13,Nelson Marlborough,0,49,0,49
2021-06-13,Mid Central,0,33,0,33
2021-06-13,Lakes,0,16,0,16
2021-06-13,Hutt Valley,0,24,0,24
2021-06-13,Hawke's Bay,0,44,0,44
2021-06-13,Counties Manukau,0,231,1,232
2021-06-13,Capital and Coast,0,94,2,96
2021-06-13,Canterbury,0,156,12,168
2021-06-13,Bay of Plenty,0,48,0,48
2021-06-13,Managed Isolation & Quarantine,27,945,1,973
2021-06-13,Total,27,2655,26,2708
2021-06-14,Auckland,0,225,1,226
2021-06-14,Whanganui,0,9,0,9
2021-06-14,West Coast,0,4,1,5
2021-06-14,Waitemata,0,296,4,300
2021-06-14,Wairarapa,0,8,0,8
2021-06-14,Waikato,0,193,2,195
2021-06-14,Taranaki,0,16,0,16
2021-06-14,Tairawhiti,0,4,0,4
2021-06-14,Southern,0,215,2,217
2021-06-14,South Canterbury,0,17,0,17
2021-06-14,Northland,0,28,0,28
2021-06-14,Nelson Marlborough,0,49,0,49
2021-06-14,Mid Central,0,33,0,33
2021-06-14,Lakes,0,16,0,16
2021-06-14,Hutt Valley,0,24,0,24
2021-06-14,Hawke's Bay,0,44,0,44
2021-06-14,Counties Manukau,0,231,1,232
2021-06-14,Capital and Coast,0,94,2,96
2021-06-14,Canterbury,0,156,12,168
2021-06-14,Bay of Plenty,0,48,0,48
2021-06-14,Managed Isolation & Quarantine,27,946,1,974
2021-06-14,Total,27,2656,26,2709
2021-06-15,Auckland,0,225,1,226
2021-06-15,Whanganui,0,9,0,9
2021-06-15,West Coast,0,4,1,5
2021-06-15,Waitemata,0,296,4,300
2021-06-15,Wairarapa,0,8,0,8
2021-06-15,Waikato,0,193,2,195
2021-06-15,Taranaki,0,16,0,16
2021-06-15,Tairawhiti,0,4,0,4
2021-06-15,Southern,0,216,2,218
2021-06-15,South Canterbury,0,17,0,17
2021-06-15,Northland,0,28,0,28
2021-06-15,Nelson Marlborough,0,49,0,49
2021-06-15,Mid Central,0,33,0,33
2021-06-15,Lakes,0,16,0,16
2021-06-15,Hutt Valley,0,24,0,24
2021-06-15,Hawke's Bay,0,44,0,44
2021-06-15,Counties Manukau,0,231,1,232
2021-06-15,Capital and Coast,0,94,2,96
2021-06-15,Canterbury,0,156,12,168
2021-06-15,Bay of Plenty,0,48,0,48
2021-06-15,Managed Isolation & Quarantine,23,949,1,973
2021-06-15,Total,23,2660,26,2709
2021-06-16,Auckland,0,225,1,226
2021-06-16,Whanganui,0,9,0,9
2021-06-16,West Coast,0,4,1,5
2021-06-16,Waitemata,0,296,4,300
2021-06-16,Wairarapa,0,8,0,8
2021-06-16,Waikato,0,193,2,195
2021-06-16,Taranaki,0,16,0,16
2021-06-16,Tairawhiti,0,4,0,4
2021-06-16,Southern,0,216,2,218
2021-06-16,South Canterbury,0,17,0,17
2021-06-16,Northland,0,28,0,28
2021-06-16,Nelson Marlborough,0,49,0,49
2021-06-16,Mid Central,0,33,0,33
2021-06-16,Lakes,0,16,0,16
2021-06-16,Hutt Valley,0,24,0,24
2021-06-16,Hawke's Bay,0,44,0,44
2021-06-16,Counties Manukau,0,231,1,232
2021-06-16,Capital and Coast,0,94,2,96
2021-06-16,Canterbury,0,156,12,168
2021-06-16,Bay of Plenty,0,48,0,48
2021-06-16,Managed Isolation & Quarantine,23,951,1,975
2021-06-16,Total,23,2662,26,2711
2021-06-17,Auckland,0,225,1,226
2021-06-17,Whanganui,0,9,0,9
2021-06-17,West Coast,0,4,1,5
2021-06-17,Waitemata,0,296,4,300
2021-06-17,Wairarapa,0,8,0,8
2021-06-17,Waikato,0,193,2,195
2021-06-17,Taranaki,0,16,0,16
2021-06-17,Tairawhiti,0,4,0,4
2021-06-17,Southern,0,216,2,218
2021-06-17,South Canterbury,0,17,0,17
2021-06-17,Northland,0,28,0,28
2021-06-17,Nelson Marlborough,0,49,0,49
2021-06-17,Mid Central,0,33,0,33
2021-06-17,Lakes,0,16,0,16
2021-06-17,Hutt Valley,0,24,0,24
2021-06-17,Hawke's Bay,0,44,0,44
2021-06-17,Counties Manukau,0,231,1,232
2021-06-17,Capital and Coast,0,94,2,96
2021-06-17,Canterbury,0,156,12,168
2021-06-17,Bay of Plenty,0,48,0,48
2021-06-17,Managed Isolation & Quarantine,24,952,1,977
2021-06-17,Total,24,2663,26,2713
2021-06-18,Auckland,0,225,1,226
2021-06-18,Whanganui,0,9,0,9
2021-06-18,West Coast,0,4,1,5
2021-06-18,Waitemata,0,296,4,300
2021-06-18,Wairarapa,0,8,0,8
2021-06-18,Waikato,0,193,2,195
2021-06-18,Taranaki,0,16,0,16
2021-06-18,Tairawhiti,0,4,0,4
2021-06-18,Southern,0,216,2,218
2021-06-18,South Canterbury,0,17,0,17
2021-06-18,Northland,0,28,0,28
2021-06-18,Nelson Marlborough,0,49,0,49
2021-06-18,Mid Central,0,33,0,33
2021-06-18,Lakes,0,16,0,16
2021-06-18,Hutt Valley,0,24,0,24
2021-06-18,Hawke's Bay,0,44,0,44
2021-06-18,Counties Manukau,0,231,1,232
2021-06-18,Capital and Coast,0,94,2,96
2021-06-18,Canterbury,0,156,12,168
2021-06-18,Bay of Plenty,0,48,0,48
2021-06-18,Managed Isolation & Quarantine,23,954,1,978
2021-06-18,Total,23,2665,26,2714
2021-06-20,Auckland,0,225,1,226
2021-06-20,Whanganui,0,9,0,9
2021-06-20,West Coast,0,4,1,5
2021-06-20,Waitemata,0,296,4,300
2021-06-20,Wairarapa,0,8,0,8
2021-06-20,Waikato,0,193,2,195
2021-06-20,Taranaki,0,16,0,16
2021-06-20,Tairawhiti,0,4,0,4
2021-06-20,Southern,0,216,2,218
2021-06-20,South Canterbury,0,17,0,17
2021-06-20,Northland,0,28,0,28
2021-06-20,Nelson Marlborough,0,49,0,49
2021-06-20,Mid Central,0,33,0,33
2021-06-20,Lakes,0,16,0,16
2021-06-20,Hutt Valley,0,24,0,24
2021-06-20,Hawke's Bay,0,44,0,44
2021-06-20,Counties Manukau,0,231,1,232
2021-06-20,Capital and Coast,0,94,2,96
2021-06-20,Canterbury,0,156,12,168
2021-06-20,Bay of Plenty,0,48,0,48
2021-06-20,Managed Isolation & Quarantine,22,959,1,982
2021-06-20,Total,22,2670,26,2718
2021-06-21,Auckland,0,225,1,226
2021-06-21,Whanganui,0,9,0,9
2021-06-21,West Coast,0,4,1,5
2021-06-21,Waitemata,0,296,4,300
2021-06-21,Wairarapa,0,8,0,8
2021-06-21,Waikato,0,193,2,195
2021-06-21,Taranaki,0,16,0,16
2021-06-21,Tairawhiti,0,4,0,4
2021-06-21,Southern,0,216,2,218
2021-06-21,South Canterbury,0,17,0,17
2021-06-21,Northland,0,28,0,28
2021-06-21,Nelson Marlborough,0,49,0,49
2021-06-21,Mid Central,0,33,0,33
2021-06-21,Lakes,0,16,0,16
2021-06-21,Hutt Valley,0,24,0,24
2021-06-21,Hawke's Bay,0,44,0,44
2021-06-21,Counties Manukau,0,231,1,232
2021-06-21,Capital and Coast,0,94,2,96
2021-06-21,Canterbury,0,156,12,168
2021-06-21,Bay of Plenty,0,48,0,48
2021-06-21,Managed Isolation & Quarantine,23,960,1,984
2021-06-21,Total,23,2671,26,2720
2021-06-22,Auckland,0,225,1,226
2021-06-22,Whanganui,0,9,0,9
2021-06-22,West Coast,0,4,1,5
2021-06-22,Waitemata,0,296,4,300
2021-06-22,Wairarapa,0,8,0,8
2021-06-22,Waikato,0,193,2,195
2021-06-22,Taranaki,0,16,0,16
2021-06-22,Tairawhiti,0,4,0,4
2021-06-22,Southern,0,216,2,218
2021-06-22,South Canterbury,0,17,0,17
2021-06-22,Northland,0,28,0,28
2021-06-22,Nelson Marlborough,0,49,0,49
2021-06-22,Mid Central,0,33,0,33
2021-06-22,Lakes,0,16,0,16
2021-06-22,Hutt Valley,0,24,0,24
2021-06-22,Hawke's Bay,0,44,0,44
2021-06-22,Counties Manukau,0,231,1,232
2021-06-22,Capital and Coast,0,94,2,96
2021-06-22,Canterbury,0,156,12,168
2021-06-22,Bay of Plenty,0,48,0,48
2021-06-22,Managed Isolation & Quarantine,20,962,1,983
2021-06-22,Total,20,2673,26,2719
2021-06-23,Auckland,0,225,1,226
2021-06-23,Whanganui,0,9,0,9
2021-06-23,West Coast,0,4,1,5
2021-06-23,Waitemata,0,296,4,300
2021-06-23,Wairarapa,0,8,0,8
2021-06-23,Waikato,0,193,2,195
2021-06-23,Taranaki,0,16,0,16
2021-06-23,Tairawhiti,0,4,0,4
2021-06-23,Southern,0,216,2,218
2021-06-23,South Canterbury,0,17,0,17
2021-06-23,Northland,0,28,0,28
2021-06-23,Nelson Marlborough,0,49,0,49
2021-06-23,Mid Central,0,33,0,33
2021-06-23,Lakes,0,16,0,16
2021-06-23,Hutt Valley,0,24,0,24
2021-06-23,Hawke's Bay,0,44,0,44
2021-06-23,Counties Manukau,0,231,1,232
2021-06-23,Capital and Coast,0,94,2,96
2021-06-23,Canterbury,0,156,12,168
2021-06-23,Bay of Plenty,0,48,0,48
2021-06-23,Managed Isolation & Quarantine,24,962,1,987
2021-06-23,Total,24,2673,26,2723
2021-06-24,Auckland,0,225,1,226
2021-06-24,Whanganui,0,9,0,9
2021-06-24,West Coast,0,4,1,5
2021-06-24,Waitemata,0,296,4,300
2021-06-24,Wairarapa,0,8,0,8
2021-06-24,Waikato,0,193,2,195
2021-06-24,Taranaki,0,16,0,16
2021-06-24,Tairawhiti,0,4,0,4
2021-06-24,Southern,0,216,2,218
2021-06-24,South Canterbury,0,17,0,17
2021-06-24,Northland,0,28,0,28
2021-06-24,Nelson Marlborough,0,49,0,49
2021-06-24,Mid Central,0,33,0,33
2021-06-24,Lakes,0,16,0,16
2021-06-24,Hutt Valley,0,24,0,24
2021-06-24,Hawke's Bay,0,44,0,44
2021-06-24,Counties Manukau,0,231,1,232
2021-06-24,Capital and Coast,0,94,2,96
2021-06-24,Canterbury,0,156,12,168
2021-06-24,Bay of Plenty,0,48,0,48
2021-06-24,Managed Isolation & Quarantine,17,969,1,987
2021-06-24,Total,17,2680,26,2723
2021-06-25,Auckland,0,225,1,226
2021-06-25,Whanganui,0,9,0,9
2021-06-25,West Coast,0,4,1,5
2021-06-25,Waitemata,0,296,4,300
2021-06-25,Wairarapa,0,8,0,8
2021-06-25,Waikato,0,193,2,195
2021-06-25,Taranaki,0,16,0,16
2021-06-25,Tairawhiti,0,4,0,4
2021-06-25,Southern,0,216,2,218
2021-06-25,South Canterbury,0,17,0,17
2021-06-25,Northland,0,28,0,28
2021-06-25,Nelson Marlborough,0,49,0,49
2021-06-25,Mid Central,0,33,0,33
2021-06-25,Lakes,0,16,0,16
2021-06-25,Hutt Valley,0,24,0,24
2021-06-25,Hawke's Bay,0,44,0,44
2021-06-25,Counties Manukau,0,231,1,232
2021-06-25,Capital and Coast,0,94,2,96
2021-06-25,Canterbury,0,156,12,168
2021-06-25,Bay of Plenty,0,48,0,48
2021-06-25,Managed Isolation & Quarantine,19,969,1,989
2021-06-25,Total,19,2680,26,2725
2021-06-26,Auckland,0,225,1,226
2021-06-26,Whanganui,0,9,0,9
2021-06-26,West Coast,0,4,1,5
2021-06-26,Waitemata,0,296,4,300
2021-06-26,Wairarapa,0,8,0,8
2021-06-26,Waikato,0,193,2,195
2021-06-26,Taranaki,0,16,0,16
2021-06-26,Tairawhiti,0,4,0,4
2021-06-26,Southern,0,216,2,218
2021-06-26,South Canterbury,0,17,0,17
2021-06-26,Northland,0,28,0,28
2021-06-26,Nelson Marlborough,0,49,0,49
2021-06-26,Mid Central,0,33,0,33
2021-06-26,Lakes,0,16,0,16
2021-06-26,Hutt Valley,0,24,0,24
2021-06-26,Hawke's Bay,0,44,0,44
2021-06-26,Counties Manukau,0,231,1,232
2021-06-26,Capital and Coast,0,94,2,96
2021-06-26,Canterbury,0,156,12,168
2021-06-26,Bay of Plenty,0,48,0,48
2021-06-26,Managed Isolation & Quarantine,21,971,1,993
2021-06-26,Total,21,2682,26,2729
2021-06-27,Auckland,0,225,1,226
2021-06-27,Whanganui,0,9,0,9
2021-06-27,West Coast,0,4,1,5
2021-06-27,Waitemata,0,296,4,300
2021-06-27,Wairarapa,0,8,0,8
2021-06-27,Waikato,0,193,2,195
2021-06-27,Taranaki,0,16,0,16
2021-06-27,Tairawhiti,0,4,0,4
2021-06-27,Southern,0,216,2,218
2021-06-27,South Canterbury,0,17,0,17
2021-06-27,Northland,0,28,0,28
2021-06-27,Nelson Marlborough,0,49,0,49
2021-06-27,Mid Central,0,33,0,33
2021-06-27,Lakes,0,16,0,16
2021-06-27,Hutt Valley,0,24,0,24
2021-06-27,Hawke's Bay,0,44,0,44
2021-06-27,Counties Manukau,0,231,1,232
2021-06-27,Capital and Coast,0,94,2,96
2021-06-27,Canterbury,0,156,12,168
2021-06-27,Bay of Plenty,0,48,0,48
2021-06-27,Managed Isolation & Quarantine,19,972,1,992
2021-06-27,Total,19,2683,26,2728
2021-06-28,Auckland,0,225,1,226
2021-06-28,Whanganui,0,9,0,9
2021-06-28,West Coast,0,4,1,5
2021-06-28,Waitemata,0,296,4,300
2021-06-28,Wairarapa,0,8,0,8
2021-06-28,Waikato,0,193,2,195
2021-06-28,Taranaki,0,16,0,16
2021-06-28,Tairawhiti,0,4,0,4
2021-06-28,Southern,0,216,2,218
2021-06-28,South Canterbury,0,17,0,17
2021-06-28,Northland,0,28,0,28
2021-06-28,Nelson Marlborough,0,49,0,49
2021-06-28,Mid Central,0,33,0,33
2021-06-28,Lakes,0,16,0,16
2021-06-28,Hutt Valley,0,24,0,24
2021-06-28,Hawke's Bay,0,44,0,44
2021-06-28,Counties Manukau,0,231,1,232
2021-06-28,Capital and Coast,0,94,2,96
2021-06-28,Canterbury,0,156,12,168
2021-06-28,Bay of Plenty,0,48,0,48
2021-06-28,Managed Isolation & Quarantine,28,973,1,1002
2021-06-28,Total,28,2684,26,2738
2021-06-29,Auckland,0,225,1,226
2021-06-29,Whanganui,0,9,0,9
2021-06-29,West Coast,0,4,1,5
2021-06-29,Waitemata,0,296,4,300
2021-06-29,Wairarapa,0,8,0,8
2021-06-29,Waikato,0,193,2,195
2021-06-29,Taranaki,0,16,0,16
2021-06-29,Tairawhiti,0,4,0,4
2021-06-29,Southern,0,216,2,218
2021-06-29,South Canterbury,0,17,0,17
2021-06-29,Northland,0,28,0,28
2021-06-29,Nelson Marlborough,0,49,0,49
2021-06-29,Mid Central,0,33,0,33
2021-06-29,Lakes,0,16,0,16
2021-06-29,Hutt Valley,0,24,0,24
2021-06-29,Hawke's Bay,0,44,0,44
2021-06-29,Counties Manukau,0,231,1,232
2021-06-29,Capital and Coast,0,94,2,96
2021-06-29,Canterbury,0,156,12,168
2021-06-29,Bay of Plenty,0,48,0,48
2021-06-29,Managed Isolation & Quarantine,30,974,1,1005
2021-06-29,Total,30,2685,26,2741
2021-06-30,Auckland,0,225,1,226
2021-06-30,Whanganui,0,9,0,9
2021-06-30,West Coast,0,4,1,5
2021-06-30,Waitemata,0,296,4,300
2021-06-30,Wairarapa,0,8,0,8
2021-06-30,Waikato,0,193,2,195
2021-06-30,Taranaki,0,16,0,16
2021-06-30,Tairawhiti,0,4,0,4
2021-06-30,Southern,0,216,2,218
2021-06-30,South Canterbury,0,17,0,17
2021-06-30,Northland,0,28,0,28
2021-06-30,Nelson Marlborough,0,49,0,49
2021-06-30,Mid Central,0,33,0,33
2021-06-30,Lakes,0,16,0,16
2021-06-30,Hutt Valley,0,24,0,24
2021-06-30,Hawke's Bay,0,44,0,44
2021-06-30,Counties Manukau,0,231,1,232
2021-06-30,Capital and Coast,0,94,2,96
2021-06-30,Canterbury,0,156,12,168
2021-06-30,Bay of Plenty,0,48,0,48
2021-06-30,Managed Isolation & Quarantine,31,974,1,1006
2021-06-30,Total,31,2685,26,2742
2021-07-01,Auckland,0,225,1,226
2021-07-01,Whanganui,0,9,0,9
2021-07-01,West Coast,0,4,1,5
2021-07-01,Waitemata,0,296,4,300
2021-07-01,Wairarapa,0,8,0,8
2021-07-01,Waikato,0,193,2,195
2021-07-01,Taranaki,0,16,0,16
2021-07-01,Tairawhiti,0,4,0,4
2021-07-01,Southern,0,216,2,218
2021-07-01,South Canterbury,0,17,0,17
2021-07-01,Northland,0,28,0,28
2021-07-01,Nelson Marlborough,0,49,0,49
2021-07-01,Mid Central,0,33,0,33
2021-07-01,Lakes,0,16,0,16
2021-07-01,Hutt Valley,0,24,0,24
2021-07-01,Hawke's Bay,0,44,0,44
2021-07-01,Counties Manukau,0,231,1,232
2021-07-01,Capital and Coast,0,94,2,96
2021-07-01,Canterbury,0,156,12,168
2021-07-01,Bay of Plenty,0,48,0,48
2021-07-01,Managed Isolation & Quarantine,28,975,1,1004
2021-07-01,Total,28,2686,26,2740
2021-07-02,Auckland,0,225,1,226
2021-07-02,Whanganui,0,9,0,9
2021-07-02,West Coast,0,4,1,5
2021-07-02,Waitemata,0,296,4,300
2021-07-02,Wairarapa,0,8,0,8
2021-07-02,Waikato,0,193,2,195
2021-07-02,Taranaki,0,16,0,16
2021-07-02,Tairawhiti,0,4,0,4
2021-07-02,Southern,0,216,2,218
2021-07-02,South Canterbury,0,17,0,17
2021-07-02,Northland,0,28,0,28
2021-07-02,Nelson Marlborough,0,49,0,49
2021-07-02,Mid Central,0,33,0,33
2021-07-02,Lakes,0,16,0,16
2021-07-02,Hutt Valley,0,24,0,24
2021-07-02,Hawke's Bay,0,44,0,44
2021-07-02,Counties Manukau,0,231,1,232
2021-07-02,Capital and Coast,0,94,2,96
2021-07-02,Canterbury,0,156,12,168
2021-07-02,Bay of Plenty,0,48,0,48
2021-07-02,Managed Isolation & Quarantine,27,978,1,1006
2021-07-02,Total,27,2689,26,2742
2021-07-04,Auckland,0,225,1,226
2021-07-04,Whanganui,0,9,0,9
2021-07-04,West Coast,0,4,1,5
2021-07-04,Waitemata,0,296,4,300
2021-07-04,Wairarapa,0,8,0,8
2021-07-04,Waikato,0,193,2,195
2021-07-04,Taranaki,0,16,0,16
2021-07-04,Tairawhiti,0,4,0,4
2021-07-04,Southern,0,216,2,218
2021-07-04,South Canterbury,0,17,0,17
2021-07-04,Northland,0,28,0,28
2021-07-04,Nelson Marlborough,0,49,0,49
2021-07-04,Mid Central,0,33,0,33
2021-07-04,Lakes,0,16,0,16
2021-07-04,Hutt Valley,0,24,0,24
2021-07-04,Hawke's Bay,0,44,0,44
2021-07-04,Counties Manukau,0,231,1,232
2021-07-04,Capital and Coast,0,94,2,96
2021-07-04,Canterbury,0,156,12,168
2021-07-04,Bay of Plenty,0,48,0,48
2021-07-04,Managed Isolation & Quarantine,32,982,1,1015
2021-07-04,Total,32,2693,26,2751
2021-07-05,Auckland,0,225,1,226
2021-07-05,Whanganui,0,9,0,9
2021-07-05,West Coast,0,4,1,5
2021-07-05,Waitemata,0,296,4,300
2021-07-05,Wairarapa,0,8,0,8
2021-07-05,Waikato,0,193,2,195
2021-07-05,Taranaki,0,16,0,16
2021-07-05,Tairawhiti,0,4,0,4
2021-07-05,Southern,0,216,2,218
2021-07-05,South Canterbury,0,17,0,17
2021-07-05,Northland,0,28,0,28
2021-07-05,Nelson Marlborough,0,49,0,49
2021-07-05,Mid Central,0,33,0,33
2021-07-05,Lakes,0,16,0,16
2021-07-05,Hutt Valley,0,24,0,24
2021-07-05,Hawke's Bay,0,44,0,44
2021-07-05,Counties Manukau,0,231,1,232
2021-07-05,Capital and Coast,0,94,2,96
2021-07-05,Canterbury,0,156,12,168
2021-07-05,Bay of Plenty,0,48,0,48
2021-07-05,Managed Isolation & Quarantine,39,982,1,1022
2021-07-05,Total,39,2693,26,2758
2021-07-06,Auckland,0,225,1,226
2021-07-06,Whanganui,0,9,0,9
2021-07-06,West Coast,0,4,1,5
2021-07-06,Waitemata,0,296,4,300
2021-07-06,Wairarapa,0,8,0,8
2021-07-06,Waikato,0,193,2,195
2021-07-06,Taranaki,0,16,0,16
2021-07-06,Tairawhiti,0,4,0,4
2021-07-06,Southern,0,216,2,218
2021-07-06,South Canterbury,0,17,0,17
2021-07-06,Northland,0,28,0,28
2021-07-06,Nelson Marlborough,0,49,0,49
2021-07-06,Mid Central,0,33,0,33
2021-07-06,Lakes,0,16,0,16
2021-07-06,Hutt Valley,0,24,0,24
2021-07-06,Hawke's Bay,0,44,0,44
2021-07-06,Counties Manukau,0,231,1,232
2021-07-06,Capital and Coast,0,94,2,96
2021-07-06,Canterbury,0,156,12,168
2021-07-06,Bay of Plenty,0,48,0,48
2021-07-06,Managed Isolation & Quarantine,36,985,1,1022
2021-07-06,Total,36,2696,26,2758
2021-07-07,Auckland,0,225,1,226
2021-07-07,Whanganui,0,9,0,9
2021-07-07,West Coast,0,4,1,5
2021-07-07,Waitemata,0,296,4,300
2021-07-07,Wairarapa,0,8,0,8
2021-07-07,Waikato,0,193,2,195
2021-07-07,Taranaki,0,16,0,16
2021-07-07,Tairawhiti,0,4,0,4
2021-07-07,Southern,0,216,2,218
2021-07-07,South Canterbury,0,17,0,17
2021-07-07,Northland,0,28,0,28
2021-07-07,Nelson Marlborough,0,49,0,49
2021-07-07,Mid Central,0,33,0,33
2021-07-07,Lakes,0,16,0,16
2021-07-07,Hutt Valley,0,24,0,24
2021-07-07,Hawke's Bay,0,44,0,44
2021-07-07,Counties Manukau,0,231,1,232
2021-07-07,Capital and Coast,0,94,2,96
2021-07-07,Canterbury,0,156,12,168
2021-07-07,Bay of Plenty,0,48,0,48
2021-07-07,Managed Isolation & Quarantine,40,986,1,1027
2021-07-07,Total,40,2697,26,2763
2021-07-08,Auckland,0,225,1,226
2021-07-08,Whanganui,0,9,0,9
2021-07-08,West Coast,0,4,1,5
2021-07-08,Waitemata,0,296,4,300
2021-07-08,Wairarapa,0,8,0,8
2021-07-08,Waikato,0,193,2,195
2021-07-08,Taranaki,0,16,0,16
2021-07-08,Tairawhiti,0,4,0,4
2021-07-08,Southern,0,216,2,218
2021-07-08,South Canterbury,0,17,0,17
2021-07-08,Northland,0,28,0,28
2021-07-08,Nelson Marlborough,0,49,0,49
2021-07-08,Mid Central,0,33,0,33
2021-07-08,Lakes,0,16,0,16
2021-07-08,Hutt Valley,0,24,0,24
2021-07-08,Hawke's Bay,0,44,0,44
2021-07-08,Counties Manukau,0,231,1,232
2021-07-08,Capital and Coast,0,94,2,96
2021-07-08,Canterbury,0,156,12,168
2021-07-08,Bay of Plenty,0,48,0,48
2021-07-08,Managed Isolation & Quarantine,41,986,1,1028
2021-07-08,Total,41,2697,26,2764
2021-07-09,Auckland,0,225,1,226
2021-07-09,Whanganui,0,9,0,9
2021-07-09,West Coast,0,4,1,5
2021-07-09,Waitemata,0,296,4,300
2021-07-09,Wairarapa,0,8,0,8
2021-07-09,Waikato,0,193,2,195
2021-07-09,Taranaki,0,16,0,16
2021-07-09,Tairawhiti,0,4,0,4
2021-07-09,Southern,0,216,2,218
2021-07-09,South Canterbury,0,17,0,17
2021-07-09,Northland,0,28,0,28
2021-07-09,Nelson Marlborough,0,49,0,49
2021-07-09,Mid Central,0,33,0,33
2021-07-09,Lakes,0,16,0,16
2021-07-09,Hutt Valley,0,24,0,24
2021-07-09,Hawke's Bay,0,44,0,44
2021-07-09,Counties Manukau,0,231,1,232
2021-07-09,Capital and Coast,0,94,2,96
2021-07-09,Canterbury,0,156,12,168
2021-07-09,Bay of Plenty,0,48,0,48
2021-07-09,Managed Isolation & Quarantine,32,996,1,1029
2021-07-09,Total,32,2707,26,2765
2021-07-11,Auckland,0,225,1,226
2021-07-11,Whanganui,0,9,0,9
2021-07-11,West Coast,0,4,1,5
2021-07-11,Waitemata,0,296,4,300
2021-07-11,Wairarapa,0,8,0,8
2021-07-11,Waikato,0,193,2,195
2021-07-11,Taranaki,0,16,0,16
2021-07-11,Tairawhiti,0,4,0,4
2021-07-11,Southern,0,215,2,217
2021-07-11,South Canterbury,0,17,0,17
2021-07-11,Northland,0,28,0,28
2021-07-11,Nelson Marlborough,0,49,0,49
2021-07-11,Mid Central,0,33,0,33
2021-07-11,Lakes,0,16,0,16
2021-07-11,Hutt Valley,0,24,0,24
2021-07-11,Hawke's Bay,0,44,0,44
2021-07-11,Counties Manukau,0,231,1,232
2021-07-11,Capital and Coast,0,94,2,96
2021-07-11,Canterbury,0,156,12,168
2021-07-11,Bay of Plenty,0,48,0,48
2021-07-11,Managed Isolation & Quarantine,34,997,1,1032
2021-07-11,Total,34,2707,26,2767
2021-07-12,Auckland,0,225,1,226
2021-07-12,Whanganui,0,9,0,9
2021-07-12,West Coast,0,4,1,5
2021-07-12,Waitemata,0,296,4,300
2021-07-12,Wairarapa,0,8,0,8
2021-07-12,Waikato,0,193,2,195
2021-07-12,Taranaki,0,16,0,16
2021-07-12,Tairawhiti,0,4,0,4
2021-07-12,Southern,0,215,2,217
2021-07-12,South Canterbury,0,17,0,17
2021-07-12,Northland,0,28,0,28
2021-07-12,Nelson Marlborough,0,49,0,49
2021-07-12,Mid Central,0,33,0,33
2021-07-12,Lakes,0,16,0,16
2021-07-12,Hutt Valley,0,24,0,24
2021-07-12,Hawke's Bay,0,44,0,44
2021-07-12,Counties Manukau,0,231,1,232
2021-07-12,Capital and Coast,0,94,2,96
2021-07-12,Canterbury,0,156,12,168
2021-07-12,Bay of Plenty,0,48,0,48
2021-07-12,Managed Isolation & Quarantine,33,999,1,1033
2021-07-12,Total,33,2709,26,2768
2021-07-13,Auckland,0,225,1,226
2021-07-13,Whanganui,0,9,0,9
2021-07-13,West Coast,0,4,1,5
2021-07-13,Waitemata,0,296,4,300
2021-07-13,Wairarapa,0,8,0,8
2021-07-13,Waikato,0,193,2,195
2021-07-13,Taranaki,0,16,0,16
2021-07-13,Tairawhiti,0,4,0,4
2021-07-13,Southern,0,215,2,217
2021-07-13,South Canterbury,0,17,0,17
2021-07-13,Northland,0,28,0,28
2021-07-13,Nelson Marlborough,0,49,0,49
2021-07-13,Mid Central,0,33,0,33
2021-07-13,Lakes,0,16,0,16
2021-07-13,Hutt Valley,0,24,0,24
2021-07-13,Hawke's Bay,0,44,0,44
2021-07-13,Counties Manukau,0,231,1,232
2021-07-13,Capital and Coast,0,94,2,96
2021-07-13,Canterbury,0,156,12,168
2021-07-13,Bay of Plenty,0,48,0,48
2021-07-13,Managed Isolation & Quarantine,43,1007,1,1051
2021-07-13,Total,43,2717,26,2786
2021-07-14,Auckland,0,225,1,226
2021-07-14,Whanganui,0,9,0,9
2021-07-14,West Coast,0,4,1,5
2021-07-14,Waitemata,0,296,4,300
2021-07-14,Wairarapa,0,8,0,8
2021-07-14,Waikato,0,193,2,195
2021-07-14,Taranaki,0,16,0,16
2021-07-14,Tairawhiti,0,4,0,4
2021-07-14,Southern,0,215,2,217
2021-07-14,South Canterbury,0,17,0,17
2021-07-14,Northland,0,28,0,28
2021-07-14,Nelson Marlborough,0,49,0,49
2021-07-14,Mid Central,0,33,0,33
2021-07-14,Lakes,0,16,0,16
2021-07-14,Hutt Valley,0,24,0,24
2021-07-14,Hawke's Bay,0,44,0,44
2021-07-14,Counties Manukau,0,231,1,232
2021-07-14,Capital and Coast,0,94,2,96
2021-07-14,Canterbury,0,156,12,168
2021-07-14,Bay of Plenty,0,48,0,48
2021-07-14,Managed Isolation & Quarantine,42,1012,1,1055
2021-07-14,Total,42,2722,26,2790
2021-07-15,Auckland,0,225,1,226
2021-07-15,Whanganui,0,9,0,9
2021-07-15,West Coast,0,4,1,5
2021-07-15,Waitemata,0,296,4,300
2021-07-15,Wairarapa,0,8,0,8
2021-07-15,Waikato,0,193,2,195
2021-07-15,Taranaki,0,16,0,16
2021-07-15,Tairawhiti,0,4,0,4
2021-07-15,Southern,0,215,2,217
2021-07-15,South Canterbury,0,17,0,17
2021-07-15,Northland,0,28,0,28
2021-07-15,Nelson Marlborough,0,49,0,49
2021-07-15,Mid Central,0,33,0,33
2021-07-15,Lakes,0,16,0,16
2021-07-15,Hutt Valley,0,24,0,24
2021-07-15,Hawke's Bay,0,44,0,44
2021-07-15,Counties Manukau,0,231,1,232
2021-07-15,Capital and Coast,0,94,2,96
2021-07-15,Canterbury,0,156,12,168
2021-07-15,Bay of Plenty,0,48,0,48
2021-07-15,Managed Isolation & Quarantine,45,1013,1,1059
2021-07-15,Total,45,2723,26,2794
2021-07-16,Auckland,0,225,1,226
2021-07-16,Whanganui,0,9,0,9
2021-07-16,West Coast,0,4,1,5
2021-07-16,Waitemata,0,296,4,300
2021-07-16,Wairarapa,0,8,0,8
2021-07-16,Waikato,0,193,2,195
2021-07-16,Taranaki,0,16,0,16
2021-07-16,Tairawhiti,0,4,0,4
2021-07-16,Southern,0,215,2,217
2021-07-16,South Canterbury,0,17,0,17
2021-07-16,Northland,0,28,0,28
2021-07-16,Nelson Marlborough,0,49,0,49
2021-07-16,Mid Central,0,33,0,33
2021-07-16,Lakes,0,16,0,16
2021-07-16,Hutt Valley,0,24,0,24
2021-07-16,Hawke's Bay,0,44,0,44
2021-07-16,Counties Manukau,0,231,1,232
2021-07-16,Capital and Coast,0,94,2,96
2021-07-16,Canterbury,0,156,12,168
2021-07-16,Bay of Plenty,0,48,0,48
2021-07-16,Managed Isolation & Quarantine,48,1019,1,1068
2021-07-16,Total,48,2729,26,2803
2021-07-18,Auckland,0,225,1,226
2021-07-18,Whanganui,0,9,0,9
2021-07-18,West Coast,0,4,1,5
2021-07-18,Waitemata,0,296,4,300
2021-07-18,Wairarapa,0,8,0,8
2021-07-18,Waikato,0,193,2,195
2021-07-18,Taranaki,0,16,0,16
2021-07-18,Tairawhiti,0,4,0,4
2021-07-18,Southern,0,215,2,217
2021-07-18,South Canterbury,0,17,0,17
2021-07-18,Northland,0,28,0,28
2021-07-18,Nelson Marlborough,0,49,0,49
2021-07-18,Mid Central,0,33,0,33
2021-07-18,Lakes,0,16,0,16
2021-07-18,Hutt Valley,0,24,0,24
2021-07-18,Hawke's Bay,0,44,0,44
2021-07-18,Counties Manukau,0,231,1,232
2021-07-18,Capital and Coast,0,94,2,96
2021-07-18,Canterbury,0,156,12,168
2021-07-18,Bay of Plenty,0,48,0,48
2021-07-18,Managed Isolation & Quarantine,45,1033,1,1079
2021-07-18,Total,45,2743,26,2814
2021-07-19,Auckland,0,225,1,226
2021-07-19,Whanganui,0,9,0,9
2021-07-19,West Coast,0,4,1,5
2021-07-19,Waitemata,0,296,4,300
2021-07-19,Wairarapa,0,8,0,8
2021-07-19,Waikato,0,193,2,195
2021-07-19,Taranaki,0,16,0,16
2021-07-19,Tairawhiti,0,4,0,4
2021-07-19,Southern,0,215,2,217
2021-07-19,South Canterbury,0,17,0,17
2021-07-19,Northland,0,28,0,28
2021-07-19,Nelson Marlborough,0,49,0,49
2021-07-19,Mid Central,0,33,0,33
2021-07-19,Lakes,0,16,0,16
2021-07-19,Hutt Valley,0,24,0,24
2021-07-19,Hawke's Bay,0,44,0,44
2021-07-19,Counties Manukau,0,231,1,232
2021-07-19,Capital and Coast,0,94,2,96
2021-07-19,Canterbury,0,156,12,168
2021-07-19,Bay of Plenty,0,48,0,48
2021-07-19,Managed Isolation & Quarantine,47,1034,1,1082
2021-07-19,Total,47,2744,26,2817
2021-07-20,Auckland,0,225,1,226
2021-07-20,Whanganui,0,9,0,9
2021-07-20,West Coast,0,4,1,5
2021-07-20,Waitemata,0,296,4,300
2021-07-20,Wairarapa,0,8,0,8
2021-07-20,Waikato,0,193,2,195
2021-07-20,Taranaki,0,16,0,16
2021-07-20,Tairawhiti,0,4,0,4
2021-07-20,Southern,0,215,2,217
2021-07-20,South Canterbury,0,17,0,17
2021-07-20,Northland,0,28,0,28
2021-07-20,Nelson Marlborough,0,49,0,49
2021-07-20,Mid Central,0,33,0,33
2021-07-20,Lakes,0,16,0,16
2021-07-20,Hutt Valley,0,24,0,24
2021-07-20,Hawke's Bay,0,44,0,44
2021-07-20,Counties Manukau,0,231,1,232
2021-07-20,Capital and Coast,0,94,2,96
2021-07-20,Canterbury,0,156,12,168
2021-07-20,Bay of Plenty,0,48,0,48
2021-07-20,Managed Isolation & Quarantine,51,1035,1,1087
2021-07-20,Total,51,2745,26,2822
2021-07-21,Auckland,0,225,1,226
2021-07-21,Whanganui,0,9,0,9
2021-07-21,West Coast,0,4,1,5
2021-07-21,Waitemata,0,296,4,300
2021-07-21,Wairarapa,0,8,0,8
2021-07-21,Waikato,0,193,2,195
2021-07-21,Taranaki,0,16,0,16
2021-07-21,Tairawhiti,0,4,0,4
2021-07-21,Southern,0,215,2,217
2021-07-21,South Canterbury,0,17,0,17
2021-07-21,Northland,0,28,0,28
2021-07-21,Nelson Marlborough,0,49,0,49
2021-07-21,Mid Central,0,33,0,33
2021-07-21,Lakes,0,16,0,16
2021-07-21,Hutt Valley,0,24,0,24
2021-07-21,Hawke's Bay,0,44,0,44
2021-07-21,Counties Manukau,0,231,1,232
2021-07-21,Capital and Coast,0,94,2,96
2021-07-21,Canterbury,0,156,12,168
2021-07-21,Bay of Plenty,0,48,0,48
2021-07-21,Managed Isolation & Quarantine,56,1036,1,1093
2021-07-21,Total,56,2746,26,2828
2021-07-22,Auckland,0,225,1,226
2021-07-22,Whanganui,0,9,0,9
2021-07-22,West Coast,0,4,1,5
2021-07-22,Waitemata,0,296,4,300
2021-07-22,Wairarapa,0,8,0,8
2021-07-22,Waikato,0,193,2,195
2021-07-22,Taranaki,0,16,0,16
2021-07-22,Tairawhiti,0,4,0,4
2021-07-22,Southern,0,215,2,217
2021-07-22,South Canterbury,0,17,0,17
2021-07-22,Northland,0,28,0,28
2021-07-22,Nelson Marlborough,0,49,0,49
2021-07-22,Mid Central,0,33,0,33
2021-07-22,Lakes,0,16,0,16
2021-07-22,Hutt Valley,0,24,0,24
2021-07-22,Hawke's Bay,0,44,0,44
2021-07-22,Counties Manukau,0,231,1,232
2021-07-22,Capital and Coast,0,94,2,96
2021-07-22,Canterbury,0,156,12,168
2021-07-22,Bay of Plenty,0,48,0,48
2021-07-22,Managed Isolation & Quarantine,62,1037,1,1100
2021-07-22,Total,62,2747,26,2835
2021-07-23,Auckland,0,225,1,226
2021-07-23,Whanganui,0,9,0,9
2021-07-23,West Coast,0,4,1,5
2021-07-23,Waitemata,0,296,4,300
2021-07-23,Wairarapa,0,8,0,8
2021-07-23,Waikato,0,193,2,195
2021-07-23,Taranaki,0,16,0,16
2021-07-23,Tairawhiti,0,4,0,4
2021-07-23,Southern,0,215,2,217
2021-07-23,South Canterbury,0,17,0,17
2021-07-23,Northland,0,28,0,28
2021-07-23,Nelson Marlborough,0,49,0,49
2021-07-23,Mid Central,0,33,0,33
2021-07-23,Lakes,0,16,0,16
2021-07-23,Hutt Valley,0,24,0,24
2021-07-23,Hawke's Bay,0,44,0,44
2021-07-23,Counties Manukau,0,231,1,232
2021-07-23,Capital and Coast,0,94,2,96
2021-07-23,Canterbury,0,156,12,168
2021-07-23,Bay of Plenty,0,48,0,48
2021-07-23,Managed Isolation & Quarantine,80,1039,1,1120
2021-07-23,Total,80,2749,26,2855
2021-07-25,Auckland,0,225,1,226
2021-07-25,Whanganui,0,9,0,9
2021-07-25,West Coast,0,4,1,5
2021-07-25,Waitemata,0,296,4,300
2021-07-25,Wairarapa,0,8,0,8
2021-07-25,Waikato,0,193,2,195
2021-07-25,Taranaki,0,16,0,16
2021-07-25,Tairawhiti,0,4,0,4
2021-07-25,Southern,0,215,2,217
2021-07-25,South Canterbury,0,17,0,17
2021-07-25,Northland,0,28,0,28
2021-07-25,Nelson Marlborough,0,49,0,49
2021-07-25,Mid Central,0,33,0,33
2021-07-25,Lakes,0,16,0,16
2021-07-25,Hutt Valley,0,24,0,24
2021-07-25,Hawke's Bay,0,44,0,44
2021-07-25,Counties Manukau,0,231,1,232
2021-07-25,Capital and Coast,0,94,2,96
2021-07-25,Canterbury,0,156,12,168
2021-07-25,Bay of Plenty,0,48,0,48
2021-07-25,Managed Isolation & Quarantine,58,1068,1,1127
2021-07-25,Total,58,2778,26,2862
2021-07-26,Auckland,0,225,1,226
2021-07-26,Whanganui,0,9,0,9
2021-07-26,West Coast,0,4,1,5
2021-07-26,Waitemata,0,296,4,300
2021-07-26,Wairarapa,0,8,0,8
2021-07-26,Waikato,0,193,2,195
2021-07-26,Taranaki,0,16,0,16
2021-07-26,Tairawhiti,0,4,0,4
2021-07-26,Southern,0,215,2,217
2021-07-26,South Canterbury,0,17,0,17
2021-07-26,Northland,0,28,0,28
2021-07-26,Nelson Marlborough,0,49,0,49
2021-07-26,Mid Central,0,33,0,33
2021-07-26,Lakes,0,16,0,16
2021-07-26,Hutt Valley,0,24,0,24
2021-07-26,Hawke's Bay,0,44,0,44
2021-07-26,Counties Manukau,0,231,1,232
2021-07-26,Capital and Coast,0,94,2,96
2021-07-26,Canterbury,0,156,12,168
2021-07-26,Bay of Plenty,0,48,0,48
2021-07-26,Managed Isolation & Quarantine,54,1073,1,1128
2021-07-26,Total,54,2783,26,2863
2021-07-27,Auckland,0,225,1,226
2021-07-27,Whanganui,0,9,0,9
2021-07-27,West Coast,0,4,1,5
2021-07-27,Waitemata,0,296,4,300
2021-07-27,Wairarapa,0,8,0,8
2021-07-27,Waikato,0,193,2,195
2021-07-27,Taranaki,0,16,0,16
2021-07-27,Tairawhiti,0,4,0,4
2021-07-27,Southern,0,215,2,217
2021-07-27,South Canterbury,0,17,0,17
2021-07-27,Northland,0,28,0,28
2021-07-27,Nelson Marlborough,0,49,0,49
2021-07-27,Mid Central,0,33,0,33
2021-07-27,Lakes,0,16,0,16
2021-07-27,Hutt Valley,0,24,0,24
2021-07-27,Hawke's Bay,0,44,0,44
2021-07-27,Counties Manukau,0,231,1,232
2021-07-27,Capital and Coast,0,94,2,96
2021-07-27,Canterbury,0,156,12,168
2021-07-27,Bay of Plenty,0,48,0,48
2021-07-27,Managed Isolation & Quarantine,52,1075,1,1128
2021-07-27,Total,52,2785,26,2863
2021-07-28,Auckland,0,225,1,226
2021-07-28,Whanganui,0,9,0,9
2021-07-28,West Coast,0,4,1,5
2021-07-28,Waitemata,0,296,4,300
2021-07-28,Wairarapa,0,8,0,8
2021-07-28,Waikato,0,193,2,195
2021-07-28,Taranaki,0,16,0,16
2021-07-28,Tairawhiti,0,4,0,4
2021-07-28,Southern,0,215,2,217
2021-07-28,South Canterbury,0,17,0,17
2021-07-28,Northland,0,28,0,28
2021-07-28,Nelson Marlborough,0,49,0,49
2021-07-28,Mid Central,0,33,0,33
2021-07-28,Lakes,0,16,0,16
2021-07-28,Hutt Valley,0,24,0,24
2021-07-28,Hawke's Bay,0,44,0,44
2021-07-28,Counties Manukau,0,231,1,232
2021-07-28,Capital and Coast,0,94,2,96
2021-07-28,Canterbury,0,156,12,168
2021-07-28,Bay of Plenty,0,48,0,48
2021-07-28,Managed Isolation & Quarantine,43,1085,1,1129
2021-07-28,Total,43,2795,26,2864
2021-07-29,Auckland,0,225,1,226
2021-07-29,Whanganui,0,9,0,9
2021-07-29,West Coast,0,4,1,5
2021-07-29,Waitemata,0,296,4,300
2021-07-29,Wairarapa,0,8,0,8
2021-07-29,Waikato,0,193,2,195
2021-07-29,Taranaki,0,16,0,16
2021-07-29,Tairawhiti,0,4,0,4
2021-07-29,Southern,0,215,2,217
2021-07-29,South Canterbury,0,17,0,17
2021-07-29,Northland,0,28,0,28
2021-07-29,Nelson Marlborough,0,49,0,49
2021-07-29,Mid Central,0,33,0,33
2021-07-29,Lakes,0,16,0,16
2021-07-29,Hutt Valley,0,24,0,24
2021-07-29,Hawke's Bay,0,44,0,44
2021-07-29,Counties Manukau,0,231,1,232
2021-07-29,Capital and Coast,0,94,2,96
2021-07-29,Canterbury,0,156,12,168
2021-07-29,Bay of Plenty,0,48,0,48
2021-07-29,Managed Isolation & Quarantine,46,1085,1,1132
2021-07-29,Total,46,2795,26,2867
2021-07-30,Auckland,0,225,1,226
2021-07-30,Whanganui,0,9,0,9
2021-07-30,West Coast,0,4,1,5
2021-07-30,Waitemata,0,296,4,300
2021-07-30,Wairarapa,0,8,0,8
2021-07-30,Waikato,0,193,2,195
2021-07-30,Taranaki,0,16,0,16
2021-07-30,Tairawhiti,0,4,0,4
2021-07-30,Southern,0,215,2,217
2021-07-30,South Canterbury,0,17,0,17
2021-07-30,Northland,0,28,0,28
2021-07-30,Nelson Marlborough,0,49,0,49
2021-07-30,Mid Central,0,33,0,33
2021-07-30,Lakes,0,16,0,16
2021-07-30,Hutt Valley,0,24,0,24
2021-07-30,Hawke's Bay,0,44,0,44
2021-07-30,Counties Manukau,0,231,1,232
2021-07-30,Capital and Coast,0,94,2,96
2021-07-30,Canterbury,0,156,12,168
2021-07-30,Bay of Plenty,0,48,0,48
2021-07-30,Managed Isolation & Quarantine,45,1089,1,1135
2021-07-30,Total,45,2799,26,2870
2021-08-01,Auckland,0,225,1,226
2021-08-01,Whanganui,0,9,0,9
2021-08-01,West Coast,0,4,1,5
2021-08-01,Waitemata,0,296,4,300
2021-08-01,Wairarapa,0,8,0,8
2021-08-01,Waikato,0,193,2,195
2021-08-01,Taranaki,0,16,0,16
2021-08-01,Tairawhiti,0,4,0,4
2021-08-01,Southern,0,215,2,217
2021-08-01,South Canterbury,0,17,0,17
2021-08-01,Northland,0,28,0,28
2021-08-01,Nelson Marlborough,0,49,0,49
2021-08-01,Mid Central,0,33,0,33
2021-08-01,Lakes,0,16,0,16
2021-08-01,Hutt Valley,0,24,0,24
2021-08-01,Hawke's Bay,0,44,0,44
2021-08-01,Counties Manukau,0,231,1,232
2021-08-01,Capital and Coast,0,94,2,96
2021-08-01,Canterbury,0,156,12,168
2021-08-01,Bay of Plenty,0,48,0,48
2021-08-01,Managed Isolation & Quarantine,36,1101,1,1138
2021-08-01,Total,36,2811,26,2873
2021-08-02,Auckland,0,225,1,226
2021-08-02,Whanganui,0,9,0,9
2021-08-02,West Coast,0,4,1,5
2021-08-02,Waitemata,0,296,4,300
2021-08-02,Wairarapa,0,8,0,8
2021-08-02,Waikato,0,193,2,195
2021-08-02,Taranaki,0,16,0,16
2021-08-02,Tairawhiti,0,4,0,4
2021-08-02,Southern,0,215,2,217
2021-08-02,South Canterbury,0,17,0,17
2021-08-02,Northland,0,28,0,28
2021-08-02,Nelson Marlborough,0,49,0,49
2021-08-02,Mid Central,0,33,0,33
2021-08-02,Lakes,0,16,0,16
2021-08-02,Hutt Valley,0,24,0,24
2021-08-02,Hawke's Bay,0,44,0,44
2021-08-02,Counties Manukau,0,231,1,232
2021-08-02,Capital and Coast,0,94,2,96
2021-08-02,Canterbury,0,156,12,168
2021-08-02,Bay of Plenty,0,48,0,48
2021-08-02,Managed Isolation & Quarantine,37,1104,1,1142
2021-08-02,Total,37,2814,26,2877
2021-08-03,Auckland,0,225,1,226
2021-08-03,Whanganui,0,9,0,9
2021-08-03,West Coast,0,4,1,5
2021-08-03,Waitemata,0,296,4,300
2021-08-03,Wairarapa,0,8,0,8
2021-08-03,Waikato,0,193,2,195
2021-08-03,Taranaki,0,16,0,16
2021-08-03,Tairawhiti,0,4,0,4
2021-08-03,Southern,0,215,2,217
2021-08-03,South Canterbury,0,17,0,17
2021-08-03,Northland,0,28,0,28
2021-08-03,Nelson Marlborough,0,49,0,49
2021-08-03,Mid Central,0,33,0,33
2021-08-03,Lakes,0,16,0,16
2021-08-03,Hutt Valley,0,24,0,24
2021-08-03,Hawke's Bay,0,44,0,44
2021-08-03,Counties Manukau,0,231,1,232
2021-08-03,Capital and Coast,0,94,2,96
2021-08-03,Canterbury,0,156,12,168
2021-08-03,Bay of Plenty,0,48,0,48
2021-08-03,Managed Isolation & Quarantine,30,1111,1,1142
2021-08-03,Total,30,2821,26,2877
2021-08-04,Auckland,0,225,1,226
2021-08-04,Whanganui,0,9,0,9
2021-08-04,West Coast,0,4,1,5
2021-08-04,Waitemata,0,296,4,300
2021-08-04,Wairarapa,0,8,0,8
2021-08-04,Waikato,0,193,2,195
2021-08-04,Taranaki,0,16,0,16
2021-08-04,Tairawhiti,0,4,0,4
2021-08-04,Southern,0,215,2,217
2021-08-04,South Canterbury,0,17,0,17
2021-08-04,Northland,0,28,0,28
2021-08-04,Nelson Marlborough,0,49,0,49
2021-08-04,Mid Central,0,33,0,33
2021-08-04,Lakes,0,16,0,16
2021-08-04,Hutt Valley,0,24,0,24
2021-08-04,Hawke's Bay,0,44,0,44
2021-08-04,Counties Manukau,0,231,1,232
2021-08-04,Capital and Coast,0,94,2,96
2021-08-04,Canterbury,0,156,12,168
2021-08-04,Bay of Plenty,0,48,0,48
2021-08-04,Managed Isolation & Quarantine,29,1114,1,1144
2021-08-04,Total,29,2824,26,2879
2021-08-05,Auckland,0,225,1,226
2021-08-05,Whanganui,0,9,0,9
2021-08-05,West Coast,0,4,1,5
2021-08-05,Waitemata,0,296,4,300
2021-08-05,Wairarapa,0,8,0,8
2021-08-05,Waikato,0,193,2,195
2021-08-05,Taranaki,0,16,0,16
2021-08-05,Tairawhiti,0,4,0,4
2021-08-05,Southern,0,215,2,217
2021-08-05,South Canterbury,0,17,0,17
2021-08-05,Northland,0,28,0,28
2021-08-05,Nelson Marlborough,0,49,0,49
2021-08-05,Mid Central,0,33,0,33
2021-08-05,Lakes,0,16,0,16
2021-08-05,Hutt Valley,0,24,0,24
2021-08-05,Hawke's Bay,0,44,0,44
2021-08-05,Counties Manukau,0,231,1,232
2021-08-05,Capital and Coast,0,94,2,96
2021-08-05,Canterbury,0,156,12,168
2021-08-05,Bay of Plenty,0,48,0,48
2021-08-05,Managed Isolation & Quarantine,30,1114,1,1145
2021-08-05,Total,30,2824,26,2880
2021-08-06,Auckland,0,225,1,226
2021-08-06,Whanganui,0,9,0,9
2021-08-06,West Coast,0,4,1,5
2021-08-06,Waitemata,0,296,4,300
2021-08-06,Wairarapa,0,8,0,8
2021-08-06,Waikato,0,193,2,195
2021-08-06,Taranaki,0,16,0,16
2021-08-06,Tairawhiti,0,4,0,4
2021-08-06,Southern,0,215,2,217
2021-08-06,South Canterbury,0,17,0,17
2021-08-06,Northland,0,28,0,28
2021-08-06,Nelson Marlborough,0,49,0,49
2021-08-06,Mid Central,0,33,0,33
2021-08-06,Lakes,0,16,0,16
2021-08-06,Hutt Valley,0,24,0,24
2021-08-06,Hawke's Bay,0,44,0,44
2021-08-06,Counties Manukau,0,231,1,232
2021-08-06,Capital and Coast,0,94,2,96
2021-08-06,Canterbury,0,156,12,168
2021-08-06,Bay of Plenty,0,48,0,48
2021-08-06,Managed Isolation & Quarantine,25,1119,1,1145
2021-08-06,Total,25,2829,26,2880
2021-08-08,Auckland,0,225,1,226
2021-08-08,Whanganui,0,9,0,9
2021-08-08,West Coast,0,4,1,5
2021-08-08,Waitemata,0,296,4,300
2021-08-08,Wairarapa,0,8,0,8
2021-08-08,Waikato,0,193,2,195
2021-08-08,Taranaki,0,16,0,16
2021-08-08,Tairawhiti,0,4,0,4
2021-08-08,Southern,0,215,2,217
2021-08-08,South Canterbury,0,17,0,17
2021-08-08,Northland,0,28,0,28
2021-08-08,Nelson Marlborough,0,49,0,49
2021-08-08,Mid Central,0,33,0,33
2021-08-08,Lakes,0,16,0,16
2021-08-08,Hutt Valley,0,24,0,24
2021-08-08,Hawke's Bay,0,44,0,44
2021-08-08,Counties Manukau,0,231,1,232
2021-08-08,Capital and Coast,0,94,2,96
2021-08-08,Canterbury,0,156,12,168
2021-08-08,Bay of Plenty,0,48,0,48
2021-08-08,Managed Isolation & Quarantine,32,1118,1,1151
2021-08-08,Total,32,2828,26,2886
2021-08-09,Auckland,0,225,1,226
2021-08-09,Whanganui,0,9,0,9
2021-08-09,West Coast,0,4,1,5
2021-08-09,Waitemata,0,296,4,300
2021-08-09,Wairarapa,0,8,0,8
2021-08-09,Waikato,0,193,2,195
2021-08-09,Taranaki,0,16,0,16
2021-08-09,Tairawhiti,0,4,0,4
2021-08-09,Southern,0,215,2,217
2021-08-09,South Canterbury,0,17,0,17
2021-08-09,Northland,0,28,0,28
2021-08-09,Nelson Marlborough,0,49,0,49
2021-08-09,Mid Central,0,33,0,33
2021-08-09,Lakes,0,16,0,16
2021-08-09,Hutt Valley,0,24,0,24
2021-08-09,Hawke's Bay,0,44,0,44
2021-08-09,Counties Manukau,0,231,1,232
2021-08-09,Capital and Coast,0,94,2,96
2021-08-09,Canterbury,0,156,12,168
2021-08-09,Bay of Plenty,0,48,0,48
2021-08-09,Managed Isolation & Quarantine,26,1128,1,1155
2021-08-09,Total,26,2838,26,2890
2021-08-10,Auckland,0,225,1,226
2021-08-10,Whanganui,0,9,0,9
2021-08-10,West Coast,0,4,1,5
2021-08-10,Waitemata,0,296,4,300
2021-08-10,Wairarapa,0,8,0,8
2021-08-10,Waikato,0,193,2,195
2021-08-10,Taranaki,0,16,0,16
2021-08-10,Tairawhiti,0,4,0,4
2021-08-10,Southern,0,215,2,217
2021-08-10,South Canterbury,0,17,0,17
2021-08-10,Northland,0,28,0,28
2021-08-10,Nelson Marlborough,0,49,0,49
2021-08-10,Mid Central,0,33,0,33
2021-08-10,Lakes,0,16,0,16
2021-08-10,Hutt Valley,0,24,0,24
2021-08-10,Hawke's Bay,0,44,0,44
2021-08-10,Counties Manukau,0,231,1,232
2021-08-10,Capital and Coast,0,94,2,96
2021-08-10,Canterbury,0,156,12,168
2021-08-10,Bay of Plenty,0,48,0,48
2021-08-10,Managed Isolation & Quarantine,37,1129,1,1167
2021-08-10,Total,37,2839,26,2902
2021-08-11,Auckland,0,225,1,226
2021-08-11,Whanganui,0,9,0,9
2021-08-11,West Coast,0,4,1,5
2021-08-11,Waitemata,0,296,4,300
2021-08-11,Wairarapa,0,8,0,8
2021-08-11,Waikato,0,193,2,195
2021-08-11,Taranaki,0,16,0,16
2021-08-11,Tairawhiti,0,4,0,4
2021-08-11,Southern,0,215,2,217
2021-08-11,South Canterbury,0,17,0,17
2021-08-11,Northland,0,28,0,28
2021-08-11,Nelson Marlborough,0,49,0,49
2021-08-11,Mid Central,0,33,0,33
2021-08-11,Lakes,0,16,0,16
2021-08-11,Hutt Valley,0,24,0,24
2021-08-11,Hawke's Bay,0,44,0,44
2021-08-11,Counties Manukau,0,231,1,232
2021-08-11,Capital and Coast,0,94,2,96
2021-08-11,Canterbury,0,156,12,168
2021-08-11,Bay of Plenty,0,48,0,48
2021-08-11,Managed Isolation & Quarantine,37,1131,1,1169
2021-08-11,Total,37,2841,26,2904
2021-08-12,Auckland,0,225,1,226
2021-08-12,Whanganui,0,9,0,9
2021-08-12,West Coast,0,4,1,5
2021-08-12,Waitemata,0,296,4,300
2021-08-12,Wairarapa,0,8,0,8
2021-08-12,Waikato,0,193,2,195
2021-08-12,Taranaki,0,16,0,16
2021-08-12,Tairawhiti,0,4,0,4
2021-08-12,Southern,0,215,2,217
2021-08-12,South Canterbury,0,17,0,17
2021-08-12,Northland,0,28,0,28
2021-08-12,Nelson Marlborough,0,49,0,49
2021-08-12,Mid Central,0,33,0,33
2021-08-12,Lakes,0,16,0,16
2021-08-12,Hutt Valley,0,24,0,24
2021-08-12,Hawke's Bay,0,44,0,44
2021-08-12,Counties Manukau,0,231,1,232
2021-08-12,Capital and Coast,0,94,2,96
2021-08-12,Canterbury,0,156,12,168
2021-08-12,Bay of Plenty,0,48,0,48
2021-08-12,Managed Isolation & Quarantine,43,1134,1,1178
2021-08-12,Total,43,2844,26,2913
2021-08-13,Auckland,0,225,1,226
2021-08-13,Whanganui,0,9,0,9
2021-08-13,West Coast,0,4,1,5
2021-08-13,Waitemata,0,296,4,300
2021-08-13,Wairarapa,0,8,0,8
2021-08-13,Waikato,0,193,2,195
2021-08-13,Taranaki,0,16,0,16
2021-08-13,Tairawhiti,0,4,0,4
2021-08-13,Southern,0,215,2,217
2021-08-13,South Canterbury,0,17,0,17
2021-08-13,Northland,0,28,0,28
2021-08-13,Nelson Marlborough,0,49,0,49
2021-08-13,Mid Central,0,33,0,33
2021-08-13,Lakes,0,16,0,16
2021-08-13,Hutt Valley,0,24,0,24
2021-08-13,Hawke's Bay,0,44,0,44
2021-08-13,Counties Manukau,0,231,1,232
2021-08-13,Capital and Coast,0,94,2,96
2021-08-13,Canterbury,0,156,12,168
2021-08-13,Bay of Plenty,0,48,0,48
2021-08-13,Managed Isolation & Quarantine,44,1134,1,1179
2021-08-13,Total,44,2844,26,2914
2021-08-15,Auckland,0,225,1,226
2021-08-15,Whanganui,0,9,0,9
2021-08-15,West Coast,0,4,1,5
2021-08-15,Waitemata,0,296,4,300
2021-08-15,Wairarapa,0,8,0,8
2021-08-15,Waikato,0,193,2,195
2021-08-15,Taranaki,0,16,0,16
2021-08-15,Tairawhiti,0,4,0,4
2021-08-15,Southern,0,215,2,217
2021-08-15,South Canterbury,0,17,0,17
2021-08-15,Northland,0,28,0,28
2021-08-15,Nelson Marlborough,0,49,0,49
2021-08-15,Mid Central,0,33,0,33
2021-08-15,Lakes,0,16,0,16
2021-08-15,Hutt Valley,0,24,0,24
2021-08-15,Hawke's Bay,0,44,0,44
2021-08-15,Counties Manukau,0,231,1,232
2021-08-15,Capital and Coast,0,94,2,96
2021-08-15,Canterbury,0,156,12,168
2021-08-15,Bay of Plenty,0,48,0,48
2021-08-15,Managed Isolation & Quarantine,39,1144,1,1184
2021-08-15,Total,39,2854,26,2919
2021-08-16,Auckland,0,225,1,226
2021-08-16,Whanganui,0,9,0,9
2021-08-16,West Coast,0,4,1,5
2021-08-16,Waitemata,0,296,4,300
2021-08-16,Wairarapa,0,8,0,8
2021-08-16,Waikato,0,193,2,195
2021-08-16,Taranaki,0,16,0,16
2021-08-16,Tairawhiti,0,4,0,4
2021-08-16,Southern,0,215,2,217
2021-08-16,South Canterbury,0,17,0,17
2021-08-16,Northland,0,28,0,28
2021-08-16,Nelson Marlborough,0,49,0,49
2021-08-16,Mid Central,0,33,0,33
2021-08-16,Lakes,0,16,0,16
2021-08-16,Hutt Valley,0,24,0,24
2021-08-16,Hawke's Bay,0,44,0,44
2021-08-16,Counties Manukau,0,231,1,232
2021-08-16,Capital and Coast,0,94,2,96
2021-08-16,Canterbury,0,156,12,168
2021-08-16,Bay of Plenty,0,48,0,48
2021-08-16,Managed Isolation & Quarantine,44,1146,1,1191
2021-08-16,Total,44,2856,26,2926
2021-08-17,Auckland,0,225,1,226
2021-08-17,Whanganui,0,9,0,9
2021-08-17,West Coast,0,4,1,5
2021-08-17,Waitemata,0,296,4,300
2021-08-17,Wairarapa,0,8,0,8
2021-08-17,Waikato,0,193,2,195
2021-08-17,Taranaki,0,16,0,16
2021-08-17,Tairawhiti,0,4,0,4
2021-08-17,Southern,0,215,2,217
2021-08-17,South Canterbury,0,17,0,17
2021-08-17,Northland,0,28,0,28
2021-08-17,Nelson Marlborough,0,49,0,49
2021-08-17,Mid Central,0,33,0,33
2021-08-17,Lakes,0,16,0,16
2021-08-17,Hutt Valley,0,24,0,24
2021-08-17,Hawke's Bay,0,44,0,44
2021-08-17,Counties Manukau,0,231,1,232
2021-08-17,Capital and Coast,0,94,2,96
2021-08-17,Canterbury,0,156,12,168
2021-08-17,Bay of Plenty,0,48,0,48
2021-08-17,Managed Isolation & Quarantine,43,1147,1,1191
2021-08-17,Total,43,2857,26,2926
2021-08-18,Auckland,1,225,1,227
2021-08-18,Whanganui,0,9,0,9
2021-08-18,West Coast,0,4,1,5
2021-08-18,Waitemata,6,296,4,306
2021-08-18,Wairarapa,0,8,0,8
2021-08-18,Waikato,0,193,2,195
2021-08-18,Taranaki,0,16,0,16
2021-08-18,Tairawhiti,0,4,0,4
2021-08-18,Southern,0,215,2,217
2021-08-18,South Canterbury,0,17,0,17
2021-08-18,Northland,0,28,0,28
2021-08-18,Nelson Marlborough,0,49,0,49
2021-08-18,Mid Central,0,33,0,33
2021-08-18,Lakes,0,16,0,16
2021-08-18,Hutt Valley,0,24,0,24
2021-08-18,Hawke's Bay,0,44,0,44
2021-08-18,Counties Manukau,0,231,1,232
2021-08-18,Capital and Coast,0,94,2,96
2021-08-18,Canterbury,0,156,12,168
2021-08-18,Bay of Plenty,0,48,0,48
2021-08-18,Managed Isolation & Quarantine,32,1161,1,1194
2021-08-18,Total,39,2871,26,2936
2021-08-19,Auckland,6,225,1,232
2021-08-19,Whanganui,0,9,0,9
2021-08-19,West Coast,0,4,1,5
2021-08-19,Waitemata,11,296,4,311
2021-08-19,Wairarapa,0,8,0,8
2021-08-19,Waikato,0,193,2,195
2021-08-19,Taranaki,0,16,0,16
2021-08-19,Tairawhiti,0,4,0,4
2021-08-19,Southern,0,215,2,217
2021-08-19,South Canterbury,0,17,0,17
2021-08-19,Northland,0,28,0,28
2021-08-19,Nelson Marlborough,0,49,0,49
2021-08-19,Mid Central,0,33,0,33
2021-08-19,Lakes,0,16,0,16
2021-08-19,Hutt Valley,0,24,0,24
2021-08-19,Hawke's Bay,0,44,0,44
2021-08-19,Counties Manukau,2,231,1,234
2021-08-19,Capital and Coast,0,94,2,96
2021-08-19,Canterbury,0,156,12,168
2021-08-19,Bay of Plenty,0,48,0,48
2021-08-19,Managed Isolation & Quarantine,36,1163,1,1200
2021-08-19,Total,55,2873,26,2954
2021-08-20,Auckland,6,225,1,232
2021-08-20,Whanganui,0,9,0,9
2021-08-20,West Coast,0,4,1,5
2021-08-20,Waitemata,19,296,4,319
2021-08-20,Wairarapa,0,8,0,8
2021-08-20,Waikato,0,193,2,195
2021-08-20,Taranaki,0,16,0,16
2021-08-20,Tairawhiti,0,4,0,4
2021-08-20,Southern,0,215,2,217
2021-08-20,South Canterbury,0,17,0,17
2021-08-20,Northland,0,28,0,28
2021-08-20,Nelson Marlborough,0,49,0,49
2021-08-20,Mid Central,0,33,0,33
2021-08-20,Lakes,0,16,0,16
2021-08-20,Hutt Valley,0,24,0,24
2021-08-20,Hawke's Bay,0,44,0,44
2021-08-20,Counties Manukau,3,231,1,235
2021-08-20,Capital and Coast,2,94,2,98
2021-08-20,Canterbury,0,156,12,168
2021-08-20,Bay of Plenty,0,48,0,48
2021-08-20,Managed Isolation & Quarantine,39,1163,1,1203
2021-08-20,Total,69,2873,26,2968
2021-08-21,Auckland,10,225,1,236
2021-08-21,Whanganui,0,9,0,9
2021-08-21,West Coast,0,4,1,5
2021-08-21,Waitemata,21,296,4,321
2021-08-21,Wairarapa,0,8,0,8
2021-08-21,Waikato,0,193,2,195
2021-08-21,Taranaki,0,16,0,16
2021-08-21,Tairawhiti,0,4,0,4
2021-08-21,Southern,0,215,2,217
2021-08-21,South Canterbury,0,17,0,17
2021-08-21,Northland,0,28,0,28
2021-08-21,Nelson Marlborough,0,49,0,49
2021-08-21,Mid Central,0,33,0,33
2021-08-21,Lakes,0,16,0,16
2021-08-21,Hutt Valley,0,24,0,24
2021-08-21,Hawke's Bay,0,44,0,44
2021-08-21,Counties Manukau,15,231,1,247
2021-08-21,Capital and Coast,5,94,2,101
2021-08-21,Canterbury,0,156,12,168
2021-08-21,Bay of Plenty,0,48,0,48
2021-08-21,Managed Isolation & Quarantine,42,1163,1,1206
2021-08-21,Total,93,2873,26,2992
2021-08-22,Auckland,18,225,1,244
2021-08-22,Whanganui,0,9,0,9
2021-08-22,West Coast,0,4,1,5
2021-08-22,Waitemata,26,296,4,326
2021-08-22,Wairarapa,0,8,0,8
2021-08-22,Waikato,0,193,2,195
2021-08-22,Taranaki,0,16,0,16
2021-08-22,Tairawhiti,0,4,0,4
2021-08-22,Southern,0,215,2,217
2021-08-22,South Canterbury,0,17,0,17
2021-08-22,Northland,0,28,0,28
2021-08-22,Nelson Marlborough,0,49,0,49
2021-08-22,Mid Central,0,33,0,33
2021-08-22,Lakes,0,16,0,16
2021-08-22,Hutt Valley,0,24,0,24
2021-08-22,Hawke's Bay,0,44,0,44
2021-08-22,Counties Manukau,22,231,1,254
2021-08-22,Capital and Coast,6,94,2,102
2021-08-22,Canterbury,0,156,12,168
2021-08-22,Bay of Plenty,0,48,0,48
2021-08-22,Managed Isolation & Quarantine,44,1164,1,1209
2021-08-22,Total,116,2874,26,3016
2021-08-23,Auckland,25,225,1,251
2021-08-23,Whanganui,0,9,0,9
2021-08-23,West Coast,0,4,1,5
2021-08-23,Waitemata,39,296,4,339
2021-08-23,Wairarapa,0,8,0,8
2021-08-23,Waikato,0,193,2,195
2021-08-23,Taranaki,0,16,0,16
2021-08-23,Tairawhiti,0,4,0,4
2021-08-23,Southern,0,215,2,217
2021-08-23,South Canterbury,0,17,0,17
2021-08-23,Northland,0,28,0,28
2021-08-23,Nelson Marlborough,0,49,0,49
2021-08-23,Mid Central,0,33,0,33
2021-08-23,Lakes,0,16,0,16
2021-08-23,Hutt Valley,0,24,0,24
2021-08-23,Hawke's Bay,0,44,0,44
2021-08-23,Counties Manukau,35,231,1,267
2021-08-23,Capital and Coast,8,94,2,104
2021-08-23,Canterbury,0,156,12,168
2021-08-23,Bay of Plenty,0,48,0,48
2021-08-23,Managed Isolation & Quarantine,47,1164,1,1212
2021-08-23,Total,154,2874,26,3054
2021-08-24,Auckland,30,225,1,256
2021-08-24,Whanganui,0,9,0,9
2021-08-24,West Coast,0,4,1,5
2021-08-24,Waitemata,47,296,4,347
2021-08-24,Wairarapa,0,8,0,8
2021-08-24,Waikato,0,193,2,195
2021-08-24,Taranaki,0,16,0,16
2021-08-24,Tairawhiti,0,4,0,4
2021-08-24,Southern,0,215,2,217
2021-08-24,South Canterbury,0,17,0,17
2021-08-24,Northland,0,28,0,28
2021-08-24,Nelson Marlborough,0,49,0,49
2021-08-24,Mid Central,0,33,0,33
2021-08-24,Lakes,0,16,0,16
2021-08-24,Hutt Valley,0,24,0,24
2021-08-24,Hawke's Bay,0,44,0,44
2021-08-24,Counties Manukau,60,231,1,292
2021-08-24,Capital and Coast,11,94,2,107
2021-08-24,Canterbury,0,156,12,168
2021-08-24,Bay of Plenty,0,48,0,48
2021-08-24,Managed Isolation & Quarantine,35,1177,1,1213
2021-08-24,Total,183,2887,26,3096
2021-08-25,Auckland,45,225,1,271
2021-08-25,Whanganui,0,9,0,9
2021-08-25,West Coast,0,4,1,5
2021-08-25,Waitemata,66,296,4,366
2021-08-25,Wairarapa,0,8,0,8
2021-08-25,Waikato,0,193,2,195
2021-08-25,Taranaki,0,16,0,16
2021-08-25,Tairawhiti,0,4,0,4
2021-08-25,Southern,0,215,2,217
2021-08-25,South Canterbury,0,17,0,17
2021-08-25,Northland,0,28,0,28
2021-08-25,Nelson Marlborough,0,49,0,49
2021-08-25,Mid Central,0,33,0,33
2021-08-25,Lakes,0,16,0,16
2021-08-25,Hutt Valley,0,24,0,24
2021-08-25,Hawke's Bay,0,44,0,44
2021-08-25,Counties Manukau,87,231,1,319
2021-08-25,Capital and Coast,12,94,2,108
2021-08-25,Canterbury,0,156,12,168
2021-08-25,Bay of Plenty,0,48,0,48
2021-08-25,Managed Isolation & Quarantine,36,1177,1,1214
2021-08-25,Total,246,2887,26,3159
2021-08-26,Auckland,60,225,1,286
2021-08-26,Whanganui,0,9,0,9
2021-08-26,West Coast,0,4,1,5
2021-08-26,Waitemata,73,296,4,373
2021-08-26,Wairarapa,0,8,0,8
2021-08-26,Waikato,0,193,2,195
2021-08-26,Taranaki,0,16,0,16
2021-08-26,Tairawhiti,0,4,0,4
2021-08-26,Southern,0,215,2,217
2021-08-26,South Canterbury,0,17,0,17
2021-08-26,Northland,0,28,0,28
2021-08-26,Nelson Marlborough,0,49,0,49
2021-08-26,Mid Central,0,33,0,33
2021-08-26,Lakes,0,16,0,16
2021-08-26,Hutt Valley,0,24,0,24
2021-08-26,Hawke's Bay,0,44,0,44
2021-08-26,Counties Manukau,130,231,1,362
2021-08-26,Capital and Coast,14,94,2,110
2021-08-26,Canterbury,0,156,12,168
2021-08-26,Bay of Plenty,0,48,0,48
2021-08-26,Managed Isolation & Quarantine,37,1177,1,1215
2021-08-26,Total,314,2887,26,3227
2021-08-27,Auckland,75,225,1,301
2021-08-27,Whanganui,0,9,0,9
2021-08-27,West Coast,0,4,1,5
2021-08-27,Waitemata,87,296,4,387
2021-08-27,Wairarapa,0,8,0,8
2021-08-27,Waikato,0,193,2,195
2021-08-27,Taranaki,0,16,0,16
2021-08-27,Tairawhiti,0,4,0,4
2021-08-27,Southern,0,215,2,217
2021-08-27,South Canterbury,0,17,0,17
2021-08-27,Northland,0,28,0,28
2021-08-27,Nelson Marlborough,0,49,0,49
2021-08-27,Mid Central,0,33,0,33
2021-08-27,Lakes,0,16,0,16
2021-08-27,Hutt Valley,0,24,0,24
2021-08-27,Hawke's Bay,0,44,0,44
2021-08-27,Counties Manukau,171,231,1,403
2021-08-27,Capital and Coast,14,94,2,110
2021-08-27,Canterbury,0,156,12,168
2021-08-27,Bay of Plenty,0,48,0,48
2021-08-27,Managed Isolation & Quarantine,37,1177,1,1215
2021-08-27,Total,384,2887,26,3297
2021-08-28,Auckland,94,225,1,320
2021-08-28,Whanganui,0,9,0,9
2021-08-28,West Coast,0,4,1,5
2021-08-28,Waitemata,102,296,4,402
2021-08-28,Wairarapa,0,8,0,8
2021-08-28,Waikato,0,193,2,195
2021-08-28,Taranaki,0,16,0,16
2021-08-28,Tairawhiti,0,4,0,4
2021-08-28,Southern,0,215,2,217
2021-08-28,South Canterbury,0,17,0,17
2021-08-28,Northland,0,28,0,28
2021-08-28,Nelson Marlborough,0,49,0,49
2021-08-28,Mid Central,0,33,0,33
2021-08-28,Lakes,0,16,0,16
2021-08-28,Hutt Valley,0,24,0,24
2021-08-28,Hawke's Bay,0,44,0,44
2021-08-28,Counties Manukau,219,231,1,451
2021-08-28,Capital and Coast,14,94,2,110
2021-08-28,Canterbury,0,156,12,168
2021-08-28,Bay of Plenty,0,48,0,48
2021-08-28,Managed Isolation & Quarantine,38,1177,1,1216
2021-08-28,Total,467,2887,26,3380
2021-08-29,Auckland,100,225,1,326
2021-08-29,Whanganui,0,9,0,9
2021-08-29,West Coast,0,4,1,5
2021-08-29,Waitemata,116,296,4,416
2021-08-29,Wairarapa,0,8,0,8
2021-08-29,Waikato,0,193,2,195
2021-08-29,Taranaki,0,16,0,16
2021-08-29,Tairawhiti,0,4,0,4
2021-08-29,Southern,0,215,2,217
2021-08-29,South Canterbury,0,17,0,17
2021-08-29,Northland,0,28,0,28
2021-08-29,Nelson Marlborough,0,49,0,49
2021-08-29,Mid Central,0,33,0,33
2021-08-29,Lakes,0,16,0,16
2021-08-29,Hutt Valley,0,24,0,24
2021-08-29,Hawke's Bay,0,44,0,44
2021-08-29,Counties Manukau,280,231,1,512
2021-08-29,Capital and Coast,15,94,2,111
2021-08-29,Canterbury,0,156,12,168
2021-08-29,Bay of Plenty,0,48,0,48
2021-08-29,Managed Isolation & Quarantine,40,1177,1,1218
2021-08-29,Total,551,2887,26,3464
2021-08-30,Auckland,106,227,1,334
2021-08-30,Whanganui,0,9,0,9
2021-08-30,West Coast,0,4,1,5
2021-08-30,Waitemata,131,296,4,431
2021-08-30,Wairarapa,0,8,0,8
2021-08-30,Waikato,0,193,2,195
2021-08-30,Taranaki,0,16,0,16
2021-08-30,Tairawhiti,0,4,0,4
2021-08-30,Southern,0,215,2,217
2021-08-30,South Canterbury,0,17,0,17
2021-08-30,Northland,0,28,0,28
2021-08-30,Nelson Marlborough,0,49,0,49
2021-08-30,Mid Central,0,33,0,33
2021-08-30,Lakes,0,16,0,16
2021-08-30,Hutt Valley,0,24,0,24
2021-08-30,Hawke's Bay,0,44,0,44
2021-08-30,Counties Manukau,310,231,1,542
2021-08-30,Capital and Coast,15,94,2,111
2021-08-30,Canterbury,0,156,12,168
2021-08-30,Bay of Plenty,0,48,0,48
2021-08-30,Managed Isolation & Quarantine,41,1178,1,1220
2021-08-30,Total,603,2890,26,3519
2021-08-31,Auckland,118,227,1,346
2021-08-31,Whanganui,0,9,0,9
2021-08-31,West Coast,0,4,1,5
2021-08-31,Waitemata,135,297,4,436
2021-08-31,Wairarapa,0,8,0,8
2021-08-31,Waikato,0,193,2,195
2021-08-31,Taranaki,0,16,0,16
2021-08-31,Tairawhiti,0,4,0,4
2021-08-31,Southern,0,215,2,217
2021-08-31,South Canterbury,0,17,0,17
2021-08-31,Northland,0,28,0,28
2021-08-31,Nelson Marlborough,0,49,0,49
2021-08-31,Mid Central,0,33,0,33
2021-08-31,Lakes,0,16,0,16
2021-08-31,Hutt Valley,0,24,0,24
2021-08-31,Hawke's Bay,0,44,0,44
2021-08-31,Counties Manukau,341,231,1,573
2021-08-31,Capital and Coast,15,94,2,111
2021-08-31,Canterbury,0,156,12,168
2021-08-31,Bay of Plenty,0,48,0,48
2021-08-31,Managed Isolation & Quarantine,42,1179,1,1222
2021-08-31,Total,651,2892,26,3569
2021-09-01,Auckland,130,227,1,358
2021-09-01,Whanganui,0,9,0,9
2021-09-01,West Coast,0,4,1,5
2021-09-01,Waitemata,163,299,4,466
2021-09-01,Wairarapa,0,8,0,8
2021-09-01,Waikato,0,193,2,195
2021-09-01,Taranaki,0,16,0,16
2021-09-01,Tairawhiti,0,4,0,4
2021-09-01,Southern,0,215,2,217
2021-09-01,South Canterbury,0,17,0,17
2021-09-01,Northland,0,28,0,28
2021-09-01,Nelson Marlborough,0,49,0,49
2021-09-01,Mid Central,1,33,0,34
2021-09-01,Lakes,0,16,0,16
2021-09-01,Hutt Valley,0,24,0,24
2021-09-01,Hawke's Bay,0,44,0,44
2021-09-01,Counties Manukau,372,232,1,605
2021-09-01,Capital and Coast,16,94,2,112
2021-09-01,Canterbury,0,156,12,168
2021-09-01,Bay of Plenty,0,48,0,48
2021-09-01,Managed Isolation & Quarantine,42,1179,1,1222
2021-09-01,Total,724,2895,26,3645
2021-09-02,Auckland,140,227,1,368
2021-09-02,Whanganui,0,9,0,9
2021-09-02,West Coast,0,4,1,5
2021-09-02,Waitemata,165,302,4,471
2021-09-02,Wairarapa,0,8,0,8
2021-09-02,Waikato,0,193,2,195
2021-09-02,Taranaki,0,16,0,16
2021-09-02,Tairawhiti,0,4,0,4
2021-09-02,Southern,0,215,2,217
2021-09-02,South Canterbury,0,17,0,17
2021-09-02,Northland,0,28,0,28
2021-09-02,Nelson Marlborough,0,49,0,49
2021-09-02,Mid Central,0,33,0,33
2021-09-02,Lakes,0,16,0,16
2021-09-02,Hutt Valley,0,24,0,24
2021-09-02,Hawke's Bay,0,44,0,44
2021-09-02,Counties Manukau,404,234,1,639
2021-09-02,Capital and Coast,16,94,2,112
2021-09-02,Canterbury,0,156,12,168
2021-09-02,Bay of Plenty,0,48,0,48
2021-09-02,Managed Isolation & Quarantine,45,1180,1,1226
2021-09-02,Total,770,2901,26,3697
2021-09-03,Auckland,138,234,1,373
2021-09-03,Whanganui,0,9,0,9
2021-09-03,West Coast,0,4,1,5
2021-09-03,Waitemata,161,309,4,474
2021-09-03,Wairarapa,0,8,0,8
2021-09-03,Waikato,0,193,2,195
2021-09-03,Taranaki,0,16,0,16
2021-09-03,Tairawhiti,0,4,0,4
2021-09-03,Southern,0,215,2,217
2021-09-03,South Canterbury,0,17,0,17
2021-09-03,Northland,0,28,0,28
2021-09-03,Nelson Marlborough,0,49,0,49
2021-09-03,Mid Central,0,33,0,33
2021-09-03,Lakes,0,16,0,16
2021-09-03,Hutt Valley,0,24,0,24
2021-09-03,Hawke's Bay,0,44,0,44
2021-09-03,Counties Manukau,416,241,1,658
2021-09-03,Capital and Coast,16,95,2,113
2021-09-03,Canterbury,0,156,12,168
2021-09-03,Bay of Plenty,0,48,0,48
2021-09-03,Managed Isolation & Quarantine,24,1205,1,1230
2021-09-03,Total,755,2948,26,3729
2021-09-04,Auckland,141,237,1,379
2021-09-04,Whanganui,0,9,0,9
2021-09-04,West Coast,0,4,1,5
2021-09-04,Waitemata,164,315,4,483
2021-09-04,Wairarapa,0,8,0,8
2021-09-04,Waikato,0,193,2,195
2021-09-04,Taranaki,0,16,0,16
2021-09-04,Tairawhiti,0,4,0,4
2021-09-04,Southern,0,215,2,217
2021-09-04,South Canterbury,0,17,0,17
2021-09-04,Northland,0,28,0,28
2021-09-04,Nelson Marlborough,0,49,0,49
2021-09-04,Mid Central,0,33,0,33
2021-09-04,Lakes,0,16,0,16
2021-09-04,Hutt Valley,0,24,0,24
2021-09-04,Hawke's Bay,0,44,0,44
2021-09-04,Counties Manukau,408,252,1,661
2021-09-04,Capital and Coast,15,96,2,113
2021-09-04,Canterbury,0,156,12,168
2021-09-04,Bay of Plenty,0,48,0,48
2021-09-04,Managed Isolation & Quarantine,23,1207,1,1231
2021-09-04,Total,751,2971,26,3748
2021-09-05,Auckland,135,246,1,382
2021-09-05,Whanganui,0,9,0,9
2021-09-05,West Coast,0,4,1,5
2021-09-05,Waitemata,159,322,5,486
2021-09-05,Wairarapa,0,8,0,8
2021-09-05,Waikato,0,193,2,195
2021-09-05,Taranaki,0,16,0,16
2021-09-05,Tairawhiti,0,4,0,4
2021-09-05,Southern,0,215,2,217
2021-09-05,South Canterbury,0,17,0,17
2021-09-05,Northland,0,28,0,28
2021-09-05,Nelson Marlborough,0,49,0,49
2021-09-05,Mid Central,0,33,0,33
2021-09-05,Lakes,0,16,0,16
2021-09-05,Hutt Valley,0,24,0,24
2021-09-05,Hawke's Bay,0,44,0,44
2021-09-05,Counties Manukau,412,261,1,674
2021-09-05,Capital and Coast,15,96,2,113
2021-09-05,Canterbury,0,156,12,168
2021-09-05,Bay of Plenty,0,48,0,48
2021-09-05,Managed Isolation & Quarantine,22,1209,1,1232
2021-09-05,Total,743,2998,27,3768
2021-09-06,Auckland,133,255,1,389
2021-09-06,Whanganui,0,9,0,9
2021-09-06,West Coast,0,4,1,5
2021-09-06,Waitemata,148,336,5,489
2021-09-06,Wairarapa,0,8,0,8
2021-09-06,Waikato,0,193,2,195
2021-09-06,Taranaki,0,16,0,16
2021-09-06,Tairawhiti,0,4,0,4
2021-09-06,Southern,0,215,2,217
2021-09-06,South Canterbury,0,17,0,17
2021-09-06,Northland,0,28,0,28
2021-09-06,Nelson Marlborough,0,49,0,49
2021-09-06,Mid Central,0,33,0,33
2021-09-06,Lakes,0,16,0,16
2021-09-06,Hutt Valley,0,24,0,24
2021-09-06,Hawke's Bay,0,44,0,44
2021-09-06,Counties Manukau,408,275,1,684
2021-09-06,Capital and Coast,15,96,2,113
2021-09-06,Canterbury,0,156,12,168
2021-09-06,Bay of Plenty,0,48,0,48
2021-09-06,Managed Isolation & Quarantine,25,1210,1,1236
2021-09-06,Total,729,3036,27,3792
2021-09-07,Auckland,129,261,1,391
2021-09-07,Whanganui,0,9,0,9
2021-09-07,West Coast,0,4,1,5
2021-09-07,Waitemata,144,341,5,490
2021-09-07,Wairarapa,0,8,0,8
2021-09-07,Waikato,0,193,2,195
2021-09-07,Taranaki,0,16,0,16
2021-09-07,Tairawhiti,0,4,0,4
2021-09-07,Southern,0,215,2,217
2021-09-07,South Canterbury,0,17,0,17
2021-09-07,Northland,0,28,0,28
2021-09-07,Nelson Marlborough,0,49,0,49
2021-09-07,Mid Central,0,33,0,33
2021-09-07,Lakes,0,16,0,16
2021-09-07,Hutt Valley,0,24,0,24
2021-09-07,Hawke's Bay,0,44,0,44
2021-09-07,Counties Manukau,413,288,1,702
2021-09-07,Capital and Coast,9,102,2,113
2021-09-07,Canterbury,0,156,12,168
2021-09-07,Bay of Plenty,0,48,0,48
2021-09-07,Managed Isolation & Quarantine,25,1210,1,1236
2021-09-07,Total,720,3066,27,3813
2021-09-08,Auckland,114,276,1,391
2021-09-08,Whanganui,0,9,0,9
2021-09-08,West Coast,0,4,1,5
2021-09-08,Waitemata,130,358,5,493
2021-09-08,Wairarapa,0,8,0,8
2021-09-08,Waikato,0,193,2,195
2021-09-08,Taranaki,0,16,0,16
2021-09-08,Tairawhiti,0,4,0,4
2021-09-08,Southern,0,215,2,217
2021-09-08,South Canterbury,0,17,0,17
2021-09-08,Northland,0,28,0,28
2021-09-08,Nelson Marlborough,0,49,0,49
2021-09-08,Mid Central,0,33,0,33
2021-09-08,Lakes,0,16,0,16
2021-09-08,Hutt Valley,0,24,0,24
2021-09-08,Hawke's Bay,0,44,0,44
2021-09-08,Counties Manukau,384,328,1,713
2021-09-08,Capital and Coast,9,102,2,113
2021-09-08,Canterbury,0,156,12,168
2021-09-08,Bay of Plenty,0,48,0,48
2021-09-08,Managed Isolation & Quarantine,21,1216,1,1238
2021-09-08,Total,658,3144,27,3829
2021-09-09,Auckland,111,283,1,395
2021-09-09,Whanganui,0,9,0,9
2021-09-09,West Coast,0,4,1,5
2021-09-09,Waitemata,126,368,5,499
2021-09-09,Wairarapa,0,8,0,8
2021-09-09,Waikato,0,193,2,195
2021-09-09,Taranaki,0,16,0,16
2021-09-09,Tairawhiti,0,4,0,4
2021-09-09,Southern,0,215,2,217
2021-09-09,South Canterbury,0,17,0,17
2021-09-09,Northland,0,28,0,28
2021-09-09,Nelson Marlborough,0,49,0,49
2021-09-09,Mid Central,0,33,0,33
2021-09-09,Lakes,0,16,0,16
2021-09-09,Hutt Valley,0,24,0,24
2021-09-09,Hawke's Bay,0,44,0,44
2021-09-09,Counties Manukau,358,356,1,715
2021-09-09,Capital and Coast,8,103,2,113
2021-09-09,Canterbury,0,156,12,168
2021-09-09,Bay of Plenty,0,48,0,48
2021-09-09,Managed Isolation & Quarantine,22,1221,1,1244
2021-09-09,Total,625,3195,27,3847
2021-09-10,Auckland,105,290,1,396
2021-09-10,Whanganui,0,9,0,9
2021-09-10,West Coast,0,4,1,5
2021-09-10,Waitemata,125,369,5,499
2021-09-10,Wairarapa,0,8,0,8
2021-09-10,Waikato,0,193,2,195
2021-09-10,Taranaki,0,16,0,16
2021-09-10,Tairawhiti,0,4,0,4
2021-09-10,Southern,0,215,2,217
2021-09-10,South Canterbury,0,17,0,17
2021-09-10,Northland,0,28,0,28
2021-09-10,Nelson Marlborough,0,49,0,49
2021-09-10,Mid Central,0,33,0,33
2021-09-10,Lakes,0,16,0,16
2021-09-10,Hutt Valley,0,24,0,24
2021-09-10,Hawke's Bay,0,44,0,44
2021-09-10,Counties Manukau,352,372,1,725
2021-09-10,Capital and Coast,8,103,2,113
2021-09-10,Canterbury,0,156,12,168
2021-09-10,Bay of Plenty,0,48,0,48
2021-09-10,Managed Isolation & Quarantine,27,1224,1,1252
2021-09-10,Total,617,3222,27,3866
2021-09-11,Auckland,106,290,1,397
2021-09-11,Whanganui,0,9,0,9
2021-09-11,West Coast,0,4,1,5
2021-09-11,Waitemata,126,369,5,500
2021-09-11,Wairarapa,0,8,0,8
2021-09-11,Waikato,0,193,2,195
2021-09-11,Taranaki,0,16,0,16
2021-09-11,Tairawhiti,0,4,0,4
2021-09-11,Southern,0,215,2,217
2021-09-11,South Canterbury,0,17,0,17
2021-09-11,Northland,0,28,0,28
2021-09-11,Nelson Marlborough,0,49,0,49
2021-09-11,Mid Central,0,33,0,33
2021-09-11,Lakes,0,16,0,16
2021-09-11,Hutt Valley,0,24,0,24
2021-09-11,Hawke's Bay,0,44,0,44
2021-09-11,Counties Manukau,373,372,1,746
2021-09-11,Capital and Coast,7,104,2,113
2021-09-11,Canterbury,0,156,12,168
2021-09-11,Bay of Plenty,0,48,0,48
2021-09-11,Managed Isolation & Quarantine,28,1224,1,1253
2021-09-11,Total,640,3223,27,3890
2021-09-12,Auckland,98,299,1,398
2021-09-12,Whanganui,0,9,0,9
2021-09-12,West Coast,0,4,1,5
2021-09-12,Waitemata,114,382,5,501
2021-09-12,Wairarapa,0,8,0,8
2021-09-12,Waikato,0,193,2,195
2021-09-12,Taranaki,0,16,0,16
2021-09-12,Tairawhiti,0,4,0,4
2021-09-12,Southern,0,215,2,217
2021-09-12,South Canterbury,0,17,0,17
2021-09-12,Northland,0,28,0,28
2021-09-12,Nelson Marlborough,0,49,0,49
2021-09-12,Mid Central,0,33,0,33
2021-09-12,Lakes,0,16,0,16
2021-09-12,Hutt Valley,0,24,0,24
2021-09-12,Hawke's Bay,0,44,0,44
2021-09-12,Counties Manukau,350,413,1,764
2021-09-12,Capital and Coast,7,104,2,113
2021-09-12,Canterbury,0,156,12,168
2021-09-12,Bay of Plenty,0,48,0,48
2021-09-12,Managed Isolation & Quarantine,30,1225,1,1256
2021-09-12,Total,599,3287,27,3913
2021-09-13,Auckland,88,310,1,399
2021-09-13,Whanganui,0,9,0,9
2021-09-13,West Coast,0,4,1,5
2021-09-13,Waitemata,114,384,5,503
2021-09-13,Wairarapa,0,8,0,8
2021-09-13,Waikato,0,193,2,195
2021-09-13,Taranaki,0,16,0,16
2021-09-13,Tairawhiti,0,4,0,4
2021-09-13,Southern,0,215,2,217
2021-09-13,South Canterbury,0,17,0,17
2021-09-13,Northland,0,28,0,28
2021-09-13,Nelson Marlborough,0,49,0,49
2021-09-13,Mid Central,0,33,0,33
2021-09-13,Lakes,0,16,0,16
2021-09-13,Hutt Valley,0,24,0,24
2021-09-13,Hawke's Bay,0,44,0,44
2021-09-13,Counties Manukau,375,418,1,794
2021-09-13,Capital and Coast,5,106,2,113
2021-09-13,Canterbury,0,156,12,168
2021-09-13,Bay of Plenty,0,48,0,48
2021-09-13,Managed Isolation & Quarantine,32,1226,1,1259
2021-09-13,Total,614,3308,27,3949
2021-09-14,Auckland,85,314,1,400
2021-09-14,Whanganui,0,9,0,9
2021-09-14,West Coast,0,4,1,5
2021-09-14,Waitemata,110,390,5,505
2021-09-14,Wairarapa,0,8,0,8
2021-09-14,Waikato,0,193,2,195
2021-09-14,Taranaki,0,16,0,16
2021-09-14,Tairawhiti,0,4,0,4
2021-09-14,Southern,0,215,2,217
2021-09-14,South Canterbury,0,17,0,17
2021-09-14,Northland,0,28,0,28
2021-09-14,Nelson Marlborough,0,49,0,49
2021-09-14,Mid Central,0,33,0,33
2021-09-14,Lakes,0,16,0,16
2021-09-14,Hutt Valley,0,24,0,24
2021-09-14,Hawke's Bay,0,44,0,44
2021-09-14,Counties Manukau,375,430,1,806
2021-09-14,Capital and Coast,5,106,2,113
2021-09-14,Canterbury,0,156,12,168
2021-09-14,Bay of Plenty,0,48,0,48
2021-09-14,Managed Isolation & Quarantine,29,1231,1,1261
2021-09-14,Total,604,3335,27,3966
2021-09-15,Auckland,73,329,1,403
2021-09-15,Whanganui,0,9,0,9
2021-09-15,West Coast,0,4,1,5
2021-09-15,Waitemata,105,395,5,505
2021-09-15,Wairarapa,0,8,0,8
2021-09-15,Waikato,0,193,2,195
2021-09-15,Taranaki,0,16,0,16
2021-09-15,Tairawhiti,0,4,0,4
2021-09-15,Southern,0,215,2,217
2021-09-15,South Canterbury,0,17,0,17
2021-09-15,Northland,0,28,0,28
2021-09-15,Nelson Marlborough,0,49,0,49
2021-09-15,Mid Central,0,33,0,33
2021-09-15,Lakes,0,16,0,16
2021-09-15,Hutt Valley,0,24,0,24
2021-09-15,Hawke's Bay,0,44,0,44
2021-09-15,Counties Manukau,347,468,1,816
2021-09-15,Capital and Coast,5,106,2,113
2021-09-15,Canterbury,0,156,12,168
2021-09-15,Bay of Plenty,0,48,0,48
2021-09-15,Managed Isolation & Quarantine,26,1236,1,1263
2021-09-15,Total,556,3398,27,3981
2021-09-16,Auckland,69,332,1,402
2021-09-16,Whanganui,0,9,0,9
2021-09-16,West Coast,0,4,1,5
2021-09-16,Waitemata,105,397,5,507
2021-09-16,Wairarapa,0,8,0,8
2021-09-16,Waikato,0,193,2,195
2021-09-16,Taranaki,0,16,0,16
2021-09-16,Tairawhiti,0,4,0,4
2021-09-16,Southern,0,215,2,217
2021-09-16,South Canterbury,0,17,0,17
2021-09-16,Northland,0,28,0,28
2021-09-16,Nelson Marlborough,0,49,0,49
2021-09-16,Mid Central,0,33,0,33
2021-09-16,Lakes,0,16,0,16
2021-09-16,Hutt Valley,0,24,0,24
2021-09-16,Hawke's Bay,0,44,0,44
2021-09-16,Counties Manukau,359,468,1,828
2021-09-16,Capital and Coast,3,108,2,113
2021-09-16,Canterbury,0,156,12,168
2021-09-16,Bay of Plenty,0,48,0,48
2021-09-16,Managed Isolation & Quarantine,29,1238,1,1268
2021-09-16,Total,565,3407,27,3999
2021-09-17,Auckland,61,343,1,405
2021-09-17,Whanganui,0,9,0,9
2021-09-17,West Coast,0,4,1,5
2021-09-17,Waitemata,89,412,5,506
2021-09-17,Wairarapa,0,8,0,8
2021-09-17,Waikato,0,193,2,195
2021-09-17,Taranaki,0,16,0,16
2021-09-17,Tairawhiti,0,4,0,4
2021-09-17,Southern,0,215,2,217
2021-09-17,South Canterbury,0,17,0,17
2021-09-17,Northland,0,28,0,28
2021-09-17,Nelson Marlborough,0,49,0,49
2021-09-17,Mid Central,0,33,0,33
2021-09-17,Lakes,0,16,0,16
2021-09-17,Hutt Valley,0,24,0,24
2021-09-17,Hawke's Bay,0,44,0,44
2021-09-17,Counties Manukau,305,531,1,837
2021-09-17,Capital and Coast,2,109,2,113
2021-09-17,Canterbury,0,156,12,168
2021-09-17,Bay of Plenty,0,48,0,48
2021-09-17,Managed Isolation & Quarantine,32,1239,1,1272
2021-09-17,Total,489,3498,27,4014
2021-09-18,Auckland,50,358,1,409
2021-09-18,Whanganui,0,9,0,9
2021-09-18,West Coast,0,4,1,5
2021-09-18,Waitemata,60,442,5,507
2021-09-18,Wairarapa,0,8,0,8
2021-09-18,Waikato,0,193,2,195
2021-09-18,Taranaki,0,16,0,16
2021-09-18,Tairawhiti,0,4,0,4
2021-09-18,Southern,0,215,2,217
2021-09-18,South Canterbury,0,17,0,17
2021-09-18,Northland,0,28,0,28
2021-09-18,Nelson Marlborough,0,49,0,49
2021-09-18,Mid Central,0,33,0,33
2021-09-18,Lakes,0,16,0,16
2021-09-18,Hutt Valley,0,24,0,24
2021-09-18,Hawke's Bay,0,44,0,44
2021-09-18,Counties Manukau,275,576,1,852
2021-09-18,Capital and Coast,1,110,2,113
2021-09-18,Canterbury,0,156,12,168
2021-09-18,Bay of Plenty,0,48,0,48
2021-09-18,Managed Isolation & Quarantine,34,1241,1,1276
2021-09-18,Total,420,3591,27,4038
2021-09-19,Auckland,45,364,1,410
2021-09-19,Whanganui,0,9,0,9
2021-09-19,West Coast,0,4,1,5
2021-09-19,Waitemata,52,450,5,507
2021-09-19,Wairarapa,0,8,0,8
2021-09-19,Waikato,0,193,2,195
2021-09-19,Taranaki,0,16,0,16
2021-09-19,Tairawhiti,0,4,0,4
2021-09-19,Southern,0,215,2,217
2021-09-19,South Canterbury,0,17,0,17
2021-09-19,Northland,0,28,0,28
2021-09-19,Nelson Marlborough,0,49,0,49
2021-09-19,Mid Central,0,33,0,33
2021-09-19,Lakes,0,16,0,16
2021-09-19,Hutt Valley,0,24,0,24
2021-09-19,Hawke's Bay,0,44,0,44
2021-09-19,Counties Manukau,264,609,1,874
2021-09-19,Capital and Coast,0,111,2,113
2021-09-19,Canterbury,0,156,12,168
2021-09-19,Bay of Plenty,0,48,0,48
2021-09-19,Managed Isolation & Quarantine,33,1241,1,1275
2021-09-19,Total,394,3639,27,4060
2021-09-20,Auckland,45,367,1,413
2021-09-20,Whanganui,0,9,0,9
2021-09-20,West Coast,0,4,1,5
2021-09-20,Waitemata,51,450,5,506
2021-09-20,Wairarapa,0,8,0,8
2021-09-20,Waikato,0,193,2,195
2021-09-20,Taranaki,0,16,0,16
2021-09-20,Tairawhiti,0,4,0,4
2021-09-20,Southern,0,215,2,217
2021-09-20,South Canterbury,0,17,0,17
2021-09-20,Northland,0,28,0,28
2021-09-20,Nelson Marlborough,0,49,0,49
2021-09-20,Mid Central,0,33,0,33
2021-09-20,Lakes,0,16,0,16
2021-09-20,Hutt Valley,0,24,0,24
2021-09-20,Hawke's Bay,0,44,0,44
2021-09-20,Counties Manukau,280,612,1,893
2021-09-20,Capital and Coast,0,111,2,113
2021-09-20,Canterbury,0,156,12,168
2021-09-20,Bay of Plenty,0,48,0,48
2021-09-20,Managed Isolation & Quarantine,34,1241,1,1276
2021-09-20,Total,410,3645,27,4082
2021-09-21,Auckland,35,379,1,415
2021-09-21,Whanganui,0,9,0,9
2021-09-21,West Coast,0,4,1,5
2021-09-21,Waitemata,34,469,5,508
2021-09-21,Wairarapa,0,8,0,8
2021-09-21,Waikato,0,193,2,195
2021-09-21,Taranaki,0,16,0,16
2021-09-21,Tairawhiti,0,4,0,4
2021-09-21,Southern,0,215,2,217
2021-09-21,South Canterbury,0,17,0,17
2021-09-21,Northland,0,28,0,28
2021-09-21,Nelson Marlborough,0,49,0,49
2021-09-21,Mid Central,0,33,0,33
2021-09-21,Lakes,0,16,0,16
2021-09-21,Hutt Valley,0,24,0,24
2021-09-21,Hawke's Bay,0,44,0,44
2021-09-21,Counties Manukau,225,677,1,903
2021-09-21,Capital and Coast,0,111,2,113
2021-09-21,Canterbury,0,156,12,168
2021-09-21,Bay of Plenty,0,48,0,48
2021-09-21,Managed Isolation & Quarantine,31,1243,1,1275
2021-09-21,Total,325,3743,27,4095
2021-09-22,Auckland,35,383,1,419
2021-09-22,Whanganui,0,9,0,9
2021-09-22,West Coast,0,4,1,5
2021-09-22,Waitemata,29,476,5,510
2021-09-22,Wairarapa,0,8,0,8
2021-09-22,Waikato,0,193,2,195
2021-09-22,Taranaki,0,16,0,16
2021-09-22,Tairawhiti,0,4,0,4
2021-09-22,Southern,0,215,2,217
2021-09-22,South Canterbury,0,17,0,17
2021-09-22,Northland,0,28,0,28
2021-09-22,Nelson Marlborough,0,49,0,49
2021-09-22,Mid Central,0,33,0,33
2021-09-22,Lakes,0,16,0,16
2021-09-22,Hutt Valley,0,24,0,24
2021-09-22,Hawke's Bay,0,44,0,44
2021-09-22,Counties Manukau,208,711,1,920
2021-09-22,Capital and Coast,0,111,2,113
2021-09-22,Canterbury,0,156,12,168
2021-09-22,Bay of Plenty,0,48,0,48
2021-09-22,Managed Isolation & Quarantine,29,1246,1,1276
2021-09-22,Total,301,3791,27,4119
2021-09-23,Auckland,37,386,1,424
2021-09-23,Whanganui,0,9,0,9
2021-09-23,West Coast,0,4,1,5
2021-09-23,Waitemata,25,481,5,511
2021-09-23,Wairarapa,0,8,0,8
2021-09-23,Waikato,0,193,2,195
2021-09-23,Taranaki,0,16,0,16
2021-09-23,Tairawhiti,0,4,0,4
2021-09-23,Southern,0,215,2,217
2021-09-23,South Canterbury,0,17,0,17
2021-09-23,Northland,0,28,0,28
2021-09-23,Nelson Marlborough,0,49,0,49
2021-09-23,Mid Central,0,33,0,33
2021-09-23,Lakes,0,16,0,16
2021-09-23,Hutt Valley,0,24,0,24
2021-09-23,Hawke's Bay,0,44,0,44
2021-09-23,Counties Manukau,199,729,1,929
2021-09-23,Capital and Coast,0,111,2,113
2021-09-23,Canterbury,0,156,12,168
2021-09-23,Bay of Plenty,0,48,0,48
2021-09-23,Managed Isolation & Quarantine,28,1248,1,1277
2021-09-23,Total,289,3819,27,4135
2021-09-24,Auckland,36,387,1,424
2021-09-24,Whanganui,0,9,0,9
2021-09-24,West Coast,0,4,1,5
2021-09-24,Waitemata,11,495,5,511
2021-09-24,Wairarapa,0,8,0,8
2021-09-24,Waikato,0,193,2,195
2021-09-24,Taranaki,0,16,0,16
2021-09-24,Tairawhiti,0,4,0,4
2021-09-24,Southern,0,215,2,217
2021-09-24,South Canterbury,0,17,0,17
2021-09-24,Northland,0,28,0,28
2021-09-24,Nelson Marlborough,0,49,0,49
2021-09-24,Mid Central,0,33,0,33
2021-09-24,Lakes,0,16,0,16
2021-09-24,Hutt Valley,0,24,0,24
2021-09-24,Hawke's Bay,0,44,0,44
2021-09-24,Counties Manukau,181,755,1,937
2021-09-24,Capital and Coast,0,111,2,113
2021-09-24,Canterbury,0,156,12,168
2021-09-24,Bay of Plenty,0,48,0,48
2021-09-24,Managed Isolation & Quarantine,28,1249,1,1278
2021-09-24,Total,256,3861,27,4144
2021-09-25,Auckland,35,389,1,425
2021-09-25,Whanganui,0,9,0,9
2021-09-25,West Coast,0,4,1,5
2021-09-25,Waitemata,13,495,5,513
2021-09-25,Wairarapa,0,8,0,8
2021-09-25,Waikato,0,193,2,195
2021-09-25,Taranaki,0,16,0,16
2021-09-25,Tairawhiti,0,4,0,4
2021-09-25,Southern,0,215,2,217
2021-09-25,South Canterbury,0,17,0,17
2021-09-25,Northland,0,28,0,28
2021-09-25,Nelson Marlborough,0,49,0,49
2021-09-25,Mid Central,0,33,0,33
2021-09-25,Lakes,0,16,0,16
2021-09-25,Hutt Valley,0,24,0,24
2021-09-25,Hawke's Bay,0,44,0,44
2021-09-25,Counties Manukau,177,773,1,951
2021-09-25,Capital and Coast,0,111,2,113
2021-09-25,Canterbury,0,156,12,168
2021-09-25,Bay of Plenty,0,48,0,48
2021-09-25,Managed Isolation & Quarantine,25,1253,1,1279
2021-09-25,Total,250,3885,27,4162
2021-09-26,Auckland,30,397,1,428
2021-09-26,Whanganui,0,9,0,9
2021-09-26,West Coast,0,4,1,5
2021-09-26,Waitemata,15,499,5,519
2021-09-26,Wairarapa,0,8,0,8
2021-09-26,Waikato,0,193,2,195
2021-09-26,Taranaki,0,16,0,16
2021-09-26,Tairawhiti,0,4,0,4
2021-09-26,Southern,0,215,2,217
2021-09-26,South Canterbury,0,17,0,17
2021-09-26,Northland,0,28,0,28
2021-09-26,Nelson Marlborough,0,49,0,49
2021-09-26,Mid Central,0,33,0,33
2021-09-26,Lakes,0,16,0,16
2021-09-26,Hutt Valley,0,24,0,24
2021-09-26,Hawke's Bay,0,44,0,44
2021-09-26,Counties Manukau,168,791,1,960
2021-09-26,Capital and Coast,0,111,2,113
2021-09-26,Canterbury,0,156,12,168
2021-09-26,Bay of Plenty,0,48,0,48
2021-09-26,Managed Isolation & Quarantine,12,1269,1,1282
2021-09-26,Total,225,3931,27,4183
2021-09-27,Auckland,30,398,1,429
2021-09-27,Whanganui,0,9,0,9
2021-09-27,West Coast,0,4,1,5
2021-09-27,Waitemata,15,499,5,519
2021-09-27,Wairarapa,0,8,0,8
2021-09-27,Waikato,0,193,2,195
2021-09-27,Taranaki,0,16,0,16
2021-09-27,Tairawhiti,0,4,0,4
2021-09-27,Southern,0,215,2,217
2021-09-27,South Canterbury,0,17,0,17
2021-09-27,Northland,0,28,0,28
2021-09-27,Nelson Marlborough,0,49,0,49
2021-09-27,Mid Central,0,33,0,33
2021-09-27,Lakes,0,16,0,16
2021-09-27,Hutt Valley,0,24,0,24
2021-09-27,Hawke's Bay,0,44,0,44
2021-09-27,Counties Manukau,166,804,1,971
2021-09-27,Capital and Coast,0,111,2,113
2021-09-27,Canterbury,0,156,12,168
2021-09-27,Bay of Plenty,0,48,0,48
2021-09-27,Managed Isolation & Quarantine,11,1269,1,1281
2021-09-27,Total,222,3945,27,4194
2021-09-28,Auckland,26,404,1,431
2021-09-28,Whanganui,0,9,0,9
2021-09-28,West Coast,0,4,1,5
2021-09-28,Waitemata,16,499,5,520
2021-09-28,Wairarapa,0,8,0,8
2021-09-28,Waikato,0,193,2,195
2021-09-28,Taranaki,0,16,0,16
2021-09-28,Tairawhiti,0,4,0,4
2021-09-28,Southern,0,215,2,217
2021-09-28,South Canterbury,0,17,0,17
2021-09-28,Northland,0,28,0,28
2021-09-28,Nelson Marlborough,0,49,0,49
2021-09-28,Mid Central,0,33,0,33
2021-09-28,Lakes,0,16,0,16
2021-09-28,Hutt Valley,0,24,0,24
2021-09-28,Hawke's Bay,0,44,0,44
2021-09-28,Counties Manukau,160,815,1,976
2021-09-28,Capital and Coast,0,111,2,113
2021-09-28,Canterbury,0,156,12,168
2021-09-28,Bay of Plenty,0,48,0,48
2021-09-28,Managed Isolation & Quarantine,14,1268,1,1283
2021-09-28,Total,216,3961,27,4204
2021-09-29,Auckland,33,406,1,440
2021-09-29,Whanganui,0,9,0,9
2021-09-29,West Coast,0,4,1,5
2021-09-29,Waitemata,24,499,5,528
2021-09-29,Wairarapa,0,8,0,8
2021-09-29,Waikato,0,193,2,195
2021-09-29,Taranaki,0,16,0,16
2021-09-29,Tairawhiti,0,4,0,4
2021-09-29,Southern,0,215,2,217
2021-09-29,South Canterbury,0,17,0,17
2021-09-29,Northland,0,28,0,28
2021-09-29,Nelson Marlborough,0,49,0,49
2021-09-29,Mid Central,0,33,0,33
2021-09-29,Lakes,0,16,0,16
2021-09-29,Hutt Valley,0,24,0,24
2021-09-29,Hawke's Bay,0,44,0,44
2021-09-29,Counties Manukau,186,817,1,1004
2021-09-29,Capital and Coast,0,111,2,113
2021-09-29,Canterbury,0,156,12,168
2021-09-29,Bay of Plenty,0,48,0,48
2021-09-29,Managed Isolation & Quarantine,13,1268,1,1282
2021-09-29,Total,256,3965,27,4248
2021-09-30,Auckland,38,406,1,445
2021-09-30,Whanganui,0,9,0,9
2021-09-30,West Coast,0,4,1,5
2021-09-30,Waitemata,24,499,5,528
2021-09-30,Wairarapa,0,8,0,8
2021-09-30,Waikato,0,193,2,195
2021-09-30,Taranaki,0,16,0,16
2021-09-30,Tairawhiti,0,4,0,4
2021-09-30,Southern,0,215,2,217
2021-09-30,South Canterbury,0,17,0,17
2021-09-30,Northland,0,28,0,28
2021-09-30,Nelson Marlborough,0,49,0,49
2021-09-30,Mid Central,0,33,0,33
2021-09-30,Lakes,0,16,0,16
2021-09-30,Hutt Valley,0,24,0,24
2021-09-30,Hawke's Bay,0,44,0,44
2021-09-30,Counties Manukau,194,823,1,1018
2021-09-30,Capital and Coast,0,111,2,113
2021-09-30,Canterbury,0,156,12,168
2021-09-30,Bay of Plenty,0,48,0,48
2021-09-30,Managed Isolation & Quarantine,16,1271,1,1288
2021-09-30,Total,272,3974,27,4273
2021-10-01,Auckland,46,406,1,453
2021-10-01,Whanganui,0,9,0,9
2021-10-01,West Coast,0,4,1,5
2021-10-01,Waitemata,25,499,5,529
2021-10-01,Wairarapa,0,8,0,8
2021-10-01,Waikato,0,193,2,195
2021-10-01,Taranaki,0,16,0,16
2021-10-01,Tairawhiti,0,4,0,4
2021-10-01,Southern,0,215,2,217
2021-10-01,South Canterbury,0,17,0,17
2021-10-01,Northland,0,28,0,28
2021-10-01,Nelson Marlborough,0,49,0,49
2021-10-01,Mid Central,0,33,0,33
2021-10-01,Lakes,0,16,0,16
2021-10-01,Hutt Valley,0,24,0,24
2021-10-01,Hawke's Bay,0,44,0,44
2021-10-01,Counties Manukau,190,838,1,1029
2021-10-01,Capital and Coast,0,111,2,113
2021-10-01,Canterbury,0,156,12,168
2021-10-01,Bay of Plenty,0,48,0,48
2021-10-01,Managed Isolation & Quarantine,14,1271,1,1286
2021-10-01,Total,275,3989,27,4291
2021-10-02,Auckland,42,415,1,458
2021-10-02,Whanganui,0,9,0,9
2021-10-02,West Coast,0,4,1,5
2021-10-02,Waitemata,25,503,5,533
2021-10-02,Wairarapa,0,8,0,8
2021-10-02,Waikato,0,193,2,195
2021-10-02,Taranaki,0,16,0,16
2021-10-02,Tairawhiti,0,4,0,4
2021-10-02,Southern,0,215,2,217
2021-10-02,South Canterbury,0,17,0,17
2021-10-02,Northland,0,28,0,28
2021-10-02,Nelson Marlborough,0,49,0,49
2021-10-02,Mid Central,0,33,0,33
2021-10-02,Lakes,0,16,0,16
2021-10-02,Hutt Valley,0,24,0,24
2021-10-02,Hawke's Bay,0,44,0,44
2021-10-02,Counties Manukau,159,886,1,1046
2021-10-02,Capital and Coast,0,111,2,113
2021-10-02,Canterbury,0,156,12,168
2021-10-02,Bay of Plenty,0,48,0,48
2021-10-02,Managed Isolation & Quarantine,13,1274,1,1288
2021-10-02,Total,239,4053,27,4319
2021-10-03,Auckland,54,416,1,471
2021-10-03,Whanganui,0,9,0,9
2021-10-03,West Coast,0,4,1,5
2021-10-03,Waitemata,30,503,5,538
2021-10-03,Wairarapa,0,8,0,8
2021-10-03,Waikato,1,193,2,196
2021-10-03,Taranaki,0,16,0,16
2021-10-03,Tairawhiti,0,4,0,4
2021-10-03,Southern,0,215,2,217
2021-10-03,South Canterbury,0,17,0,17
2021-10-03,Northland,0,28,0,28
2021-10-03,Nelson Marlborough,0,49,0,49
2021-10-03,Mid Central,0,33,0,33
2021-10-03,Lakes,0,16,0,16
2021-10-03,Hutt Valley,0,24,0,24
2021-10-03,Hawke's Bay,0,44,0,44
2021-10-03,Counties Manukau,165,894,1,1060
2021-10-03,Capital and Coast,0,111,2,113
2021-10-03,Canterbury,0,156,12,168
2021-10-03,Bay of Plenty,0,48,0,48
2021-10-03,Managed Isolation & Quarantine,13,1274,1,1288
2021-10-03,Total,263,4062,27,4352
2021-10-04,Auckland,61,416,1,478
2021-10-04,Whanganui,0,9,0,9
2021-10-04,West Coast,0,4,1,5
2021-10-04,Waitemata,37,503,5,545
2021-10-04,Wairarapa,0,8,0,8
2021-10-04,Waikato,2,193,2,197
2021-10-04,Taranaki,0,16,0,16
2021-10-04,Tairawhiti,0,4,0,4
2021-10-04,Southern,0,215,2,217
2021-10-04,South Canterbury,0,17,0,17
2021-10-04,Northland,0,28,0,28
2021-10-04,Nelson Marlborough,0,49,0,49
2021-10-04,Mid Central,0,33,0,33
2021-10-04,Lakes,0,16,0,16
2021-10-04,Hutt Valley,0,24,0,24
2021-10-04,Hawke's Bay,0,44,0,44
2021-10-04,Counties Manukau,174,899,1,1074
2021-10-04,Capital and Coast,0,111,2,113
2021-10-04,Canterbury,0,156,12,168
2021-10-04,Bay of Plenty,0,48,0,48
2021-10-04,Managed Isolation & Quarantine,13,1275,1,1289
2021-10-04,Total,287,4068,27,4382
2021-10-05,Auckland,65,417,1,483
2021-10-05,Whanganui,0,9,0,9
2021-10-05,West Coast,0,4,1,5
2021-10-05,Waitemata,42,504,5,551
2021-10-05,Wairarapa,0,8,0,8
2021-10-05,Waikato,7,194,2,203
2021-10-05,Taranaki,0,16,0,16
2021-10-05,Tairawhiti,0,4,0,4
2021-10-05,Southern,0,215,2,217
2021-10-05,South Canterbury,0,17,0,17
2021-10-05,Northland,0,28,0,28
2021-10-05,Nelson Marlborough,0,49,0,49
2021-10-05,Mid Central,0,33,0,33
2021-10-05,Lakes,0,16,0,16
2021-10-05,Hutt Valley,0,24,0,24
2021-10-05,Hawke's Bay,0,44,0,44
2021-10-05,Counties Manukau,180,900,1,1081
2021-10-05,Capital and Coast,0,111,2,113
2021-10-05,Canterbury,0,156,12,168
2021-10-05,Bay of Plenty,0,48,0,48
2021-10-05,Managed Isolation & Quarantine,14,1276,1,1291
2021-10-05,Total,308,4073,27,4408
2021-10-06,Auckland,70,417,1,488
2021-10-06,Whanganui,0,9,0,9
2021-10-06,West Coast,0,4,1,5
2021-10-06,Waitemata,52,504,5,561
2021-10-06,Wairarapa,0,8,0,8
2021-10-06,Waikato,17,193,2,212
2021-10-06,Taranaki,0,16,0,16
2021-10-06,Tairawhiti,0,4,0,4
2021-10-06,Southern,0,215,2,217
2021-10-06,South Canterbury,0,17,0,17
2021-10-06,Northland,0,28,0,28
2021-10-06,Nelson Marlborough,0,49,0,49
2021-10-06,Mid Central,0,33,0,33
2021-10-06,Lakes,0,16,0,16
2021-10-06,Hutt Valley,0,24,0,24
2021-10-06,Hawke's Bay,0,44,0,44
2021-10-06,Counties Manukau,196,900,1,1097
2021-10-06,Capital and Coast,0,111,2,113
2021-10-06,Canterbury,0,156,12,168
2021-10-06,Bay of Plenty,0,48,0,48
2021-10-06,Managed Isolation & Quarantine,15,1277,1,1293
2021-10-06,Total,350,4073,27,4450
2021-10-07,Auckland,75,417,1,493
2021-10-07,Whanganui,0,9,0,9
2021-10-07,West Coast,0,4,1,5
2021-10-07,Waitemata,62,504,5,571
2021-10-07,Wairarapa,0,8,0,8
2021-10-07,Waikato,22,193,2,217
2021-10-07,Taranaki,0,16,0,16
2021-10-07,Tairawhiti,0,4,0,4
2021-10-07,Southern,0,215,2,217
2021-10-07,South Canterbury,0,17,0,17
2021-10-07,Northland,0,28,0,28
2021-10-07,Nelson Marlborough,0,49,0,49
2021-10-07,Mid Central,0,33,0,33
2021-10-07,Lakes,0,16,0,16
2021-10-07,Hutt Valley,0,24,0,24
2021-10-07,Hawke's Bay,0,44,0,44
2021-10-07,Counties Manukau,204,900,1,1105
2021-10-07,Capital and Coast,0,111,2,113
2021-10-07,Canterbury,0,156,12,168
2021-10-07,Bay of Plenty,0,48,0,48
2021-10-07,Managed Isolation & Quarantine,13,1281,1,1295
2021-10-07,Total,376,4077,27,4480
2021-10-08,Auckland,82,417,1,500
2021-10-08,Whanganui,0,9,0,9
2021-10-08,West Coast,0,4,1,5
2021-10-08,Waitemata,75,504,5,584
2021-10-08,Wairarapa,0,8,0,8
2021-10-08,Waikato,25,193,2,220
2021-10-08,Taranaki,0,16,0,16
2021-10-08,Tairawhiti,0,4,0,4
2021-10-08,Southern,0,215,2,217
2021-10-08,South Canterbury,0,17,0,17
2021-10-08,Northland,0,28,0,28
2021-10-08,Nelson Marlborough,0,49,0,49
2021-10-08,Mid Central,0,33,0,33
2021-10-08,Lakes,0,16,0,16
2021-10-08,Hutt Valley,0,24,0,24
2021-10-08,Hawke's Bay,0,44,0,44
2021-10-08,Counties Manukau,224,900,2,1126
2021-10-08,Capital and Coast,0,111,2,113
2021-10-08,Canterbury,0,156,12,168
2021-10-08,Bay of Plenty,0,48,0,48
2021-10-08,Managed Isolation & Quarantine,16,1281,1,1298
2021-10-08,Total,422,4077,28,4527
2021-10-09,Auckland,77,424,1,502
2021-10-09,Whanganui,0,9,0,9
2021-10-09,West Coast,0,4,1,5
2021-10-09,Waitemata,82,508,5,595
2021-10-09,Wairarapa,0,8,0,8
2021-10-09,Waikato,28,193,2,223
2021-10-09,Taranaki,0,16,0,16
2021-10-09,Tairawhiti,0,4,0,4
2021-10-09,Southern,0,215,2,217
2021-10-09,South Canterbury,0,17,0,17
2021-10-09,Northland,0,28,0,28
2021-10-09,Nelson Marlborough,0,49,0,49
2021-10-09,Mid Central,0,33,0,33
2021-10-09,Lakes,0,16,0,16
2021-10-09,Hutt Valley,0,24,0,24
2021-10-09,Hawke's Bay,0,44,0,44
2021-10-09,Counties Manukau,215,927,2,1144
2021-10-09,Capital and Coast,0,111,2,113
2021-10-09,Canterbury,0,156,12,168
2021-10-09,Bay of Plenty,0,48,0,48
2021-10-09,Managed Isolation & Quarantine,17,1282,1,1300
2021-10-09,Total,419,4116,28,4563
2021-10-10,Auckland,87,427,1,515
2021-10-10,Whanganui,0,9,0,9
2021-10-10,West Coast,0,4,1,5
2021-10-10,Waitemata,92,510,5,607
2021-10-10,Wairarapa,0,8,0,8
2021-10-10,Waikato,31,193,2,226
2021-10-10,Taranaki,0,16,0,16
2021-10-10,Tairawhiti,0,4,0,4
2021-10-10,Southern,0,215,2,217
2021-10-10,South Canterbury,0,17,0,17
2021-10-10,Northland,0,28,0,28
2021-10-10,Nelson Marlborough,0,49,0,49
2021-10-10,Mid Central,0,33,0,33
2021-10-10,Lakes,0,16,0,16
2021-10-10,Hutt Valley,0,24,0,24
2021-10-10,Hawke's Bay,0,44,0,44
2021-10-10,Counties Manukau,227,946,2,1175
2021-10-10,Capital and Coast,0,111,2,113
2021-10-10,Canterbury,0,156,12,168
2021-10-10,Bay of Plenty,1,48,0,49
2021-10-10,Managed Isolation & Quarantine,18,1282,1,1301
2021-10-10,Total,456,4140,28,4624
2021-10-11,Auckland,93,428,1,522
2021-10-11,Whanganui,0,9,0,9
2021-10-11,West Coast,0,4,1,5
2021-10-11,Waitemata,105,511,5,621
2021-10-11,Wairarapa,0,8,0,8
2021-10-11,Waikato,31,193,2,226
2021-10-11,Taranaki,0,16,0,16
2021-10-11,Tairawhiti,0,4,0,4
2021-10-11,Southern,0,215,2,217
2021-10-11,South Canterbury,0,17,0,17
2021-10-11,Northland,0,28,0,28
2021-10-11,Nelson Marlborough,0,49,0,49
2021-10-11,Mid Central,0,33,0,33
2021-10-11,Lakes,0,16,0,16
2021-10-11,Hutt Valley,0,24,0,24
2021-10-11,Hawke's Bay,0,44,0,44
2021-10-11,Counties Manukau,222,965,2,1189
2021-10-11,Capital and Coast,0,111,2,113
2021-10-11,Canterbury,0,156,12,168
2021-10-11,Bay of Plenty,1,48,0,49
2021-10-11,Managed Isolation & Quarantine,17,1283,1,1301
2021-10-11,Total,469,4162,28,4659
2021-10-12,Auckland,99,431,1,531
2021-10-12,Whanganui,0,9,0,9
2021-10-12,West Coast,0,4,1,5
2021-10-12,Waitemata,112,514,5,631
2021-10-12,Wairarapa,0,8,0,8
2021-10-12,Waikato,35,193,2,230
2021-10-12,Taranaki,0,16,0,16
2021-10-12,Tairawhiti,0,4,0,4
2021-10-12,Southern,0,215,2,217
2021-10-12,South Canterbury,0,17,0,17
2021-10-12,Northland,0,28,0,28
2021-10-12,Nelson Marlborough,0,49,0,49
2021-10-12,Mid Central,0,33,0,33
2021-10-12,Lakes,0,16,0,16
2021-10-12,Hutt Valley,0,24,0,24
2021-10-12,Hawke's Bay,0,44,0,44
2021-10-12,Counties Manukau,230,977,2,1209
2021-10-12,Capital and Coast,0,111,2,113
2021-10-12,Canterbury,0,156,12,168
2021-10-12,Bay of Plenty,0,48,0,48
2021-10-12,Managed Isolation & Quarantine,18,1285,1,1304
2021-10-12,Total,494,4182,28,4704
2021-10-13,Auckland,107,431,1,539
2021-10-13,Whanganui,0,9,0,9
2021-10-13,West Coast,0,4,1,5
2021-10-13,Waitemata,135,514,5,654
2021-10-13,Wairarapa,0,8,0,8
2021-10-13,Waikato,36,194,2,232
2021-10-13,Taranaki,0,16,0,16
2021-10-13,Tairawhiti,0,4,0,4
2021-10-13,Southern,0,215,2,217
2021-10-13,South Canterbury,0,17,0,17
2021-10-13,Northland,0,28,0,28
2021-10-13,Nelson Marlborough,0,49,0,49
2021-10-13,Mid Central,0,33,0,33
2021-10-13,Lakes,0,16,0,16
2021-10-13,Hutt Valley,0,24,0,24
2021-10-13,Hawke's Bay,0,44,0,44
2021-10-13,Counties Manukau,251,978,2,1231
2021-10-13,Capital and Coast,0,111,2,113
2021-10-13,Canterbury,0,156,12,168
2021-10-13,Bay of Plenty,0,48,0,48
2021-10-13,Managed Isolation & Quarantine,18,1285,1,1304
2021-10-13,Total,547,4184,28,4759
2021-10-14,Auckland,117,431,1,549
2021-10-14,Whanganui,0,9,0,9
2021-10-14,West Coast,0,4,1,5
2021-10-14,Waitemata,175,514,5,694
2021-10-14,Wairarapa,0,8,0,8
2021-10-14,Waikato,35,195,2,232
2021-10-14,Taranaki,0,16,0,16
2021-10-14,Tairawhiti,0,4,0,4
2021-10-14,Southern,0,215,2,217
2021-10-14,South Canterbury,0,17,0,17
2021-10-14,Northland,0,28,0,28
2021-10-14,Nelson Marlborough,0,49,0,49
2021-10-14,Mid Central,0,33,0,33
2021-10-14,Lakes,0,16,0,16
2021-10-14,Hutt Valley,0,24,0,24
2021-10-14,Hawke's Bay,0,44,0,44
2021-10-14,Counties Manukau,272,978,2,1252
2021-10-14,Capital and Coast,0,111,2,113
2021-10-14,Canterbury,0,156,12,168
2021-10-14,Bay of Plenty,0,48,0,48
2021-10-14,Managed Isolation & Quarantine,18,1286,1,1305
2021-10-14,Total,617,4186,28,4831
2021-10-15,Auckland,122,431,1,554
2021-10-15,Whanganui,0,9,0,9
2021-10-15,West Coast,0,4,1,5
2021-10-15,Waitemata,205,514,5,724
2021-10-15,Wairarapa,0,8,0,8
2021-10-15,Waikato,35,195,2,232
2021-10-15,Taranaki,0,16,0,16
2021-10-15,Tairawhiti,0,4,0,4
2021-10-15,Southern,0,215,2,217
2021-10-15,South Canterbury,0,17,0,17
2021-10-15,Northland,0,28,0,28
2021-10-15,Nelson Marlborough,0,49,0,49
2021-10-15,Mid Central,0,33,0,33
2021-10-15,Lakes,0,16,0,16
2021-10-15,Hutt Valley,0,24,0,24
2021-10-15,Hawke's Bay,0,44,0,44
2021-10-15,Counties Manukau,302,978,2,1282
2021-10-15,Capital and Coast,0,111,2,113
2021-10-15,Canterbury,0,156,12,168
2021-10-15,Bay of Plenty,0,48,0,48
2021-10-15,Managed Isolation & Quarantine,19,1286,1,1306
2021-10-15,Total,683,4186,28,4897
2021-10-16,Auckland,118,447,1,566
2021-10-16,Whanganui,0,9,0,9
2021-10-16,West Coast,0,4,1,5
2021-10-16,Waitemata,207,526,5,738
2021-10-16,Wairarapa,0,8,0,8
2021-10-16,Waikato,36,195,2,233
2021-10-16,Taranaki,0,16,0,16
2021-10-16,Tairawhiti,0,4,0,4
2021-10-16,Southern,0,215,2,217
2021-10-16,South Canterbury,0,17,0,17
2021-10-16,Northland,0,28,0,28
2021-10-16,Nelson Marlborough,0,49,0,49
2021-10-16,Mid Central,0,33,0,33
2021-10-16,Lakes,0,16,0,16
2021-10-16,Hutt Valley,0,24,0,24
2021-10-16,Hawke's Bay,0,44,0,44
2021-10-16,Counties Manukau,285,1008,2,1295
2021-10-16,Capital and Coast,0,111,2,113
2021-10-16,Canterbury,0,156,12,168
2021-10-16,Bay of Plenty,0,48,0,48
2021-10-16,Managed Isolation & Quarantine,19,1288,1,1308
2021-10-16,Total,665,4246,28,4939
2021-10-17,Auckland,114,464,1,579
2021-10-17,Whanganui,0,9,0,9
2021-10-17,West Coast,0,4,1,5
2021-10-17,Waitemata,213,535,5,753
2021-10-17,Wairarapa,0,8,0,8
2021-10-17,Waikato,40,195,2,237
2021-10-17,Taranaki,0,16,0,16
2021-10-17,Tairawhiti,0,4,0,4
2021-10-17,Southern,0,215,2,217
2021-10-17,South Canterbury,0,17,0,17
2021-10-17,Northland,0,28,0,28
2021-10-17,Nelson Marlborough,0,49,0,49
2021-10-17,Mid Central,0,33,0,33
2021-10-17,Lakes,0,16,0,16
2021-10-17,Hutt Valley,0,24,0,24
2021-10-17,Hawke's Bay,0,44,0,44
2021-10-17,Counties Manukau,254,1057,2,1313
2021-10-17,Capital and Coast,0,111,2,113
2021-10-17,Canterbury,0,156,12,168
2021-10-17,Bay of Plenty,0,48,0,48
2021-10-17,Managed Isolation & Quarantine,21,1288,1,1310
2021-10-17,Total,642,4321,28,4991
2021-10-18,Auckland,104,480,1,585
2021-10-18,Whanganui,0,9,0,9
2021-10-18,West Coast,0,4,1,5
2021-10-18,Waitemata,239,543,5,787
2021-10-18,Wairarapa,0,8,0,8
2021-10-18,Waikato,42,196,2,240
2021-10-18,Taranaki,0,16,0,16
2021-10-18,Tairawhiti,0,4,0,4
2021-10-18,Southern,0,215,2,217
2021-10-18,South Canterbury,0,17,0,17
2021-10-18,Northland,0,28,0,28
2021-10-18,Nelson Marlborough,0,49,0,49
2021-10-18,Mid Central,0,33,0,33
2021-10-18,Lakes,0,16,0,16
2021-10-18,Hutt Valley,0,24,0,24
2021-10-18,Hawke's Bay,0,44,0,44
2021-10-18,Counties Manukau,248,1080,2,1330
2021-10-18,Capital and Coast,0,111,2,113
2021-10-18,Canterbury,0,156,12,168
2021-10-18,Bay of Plenty,0,48,0,48
2021-10-18,Managed Isolation & Quarantine,19,1294,1,1314
2021-10-18,Total,652,4375,28,5055
2021-10-19,Auckland,116,483,1,600
2021-10-19,Whanganui,0,9,0,9
2021-10-19,West Coast,0,4,1,5
2021-10-19,Waitemata,283,549,5,837
2021-10-19,Wairarapa,0,8,0,8
2021-10-19,Waikato,45,200,2,247
2021-10-19,Taranaki,0,16,0,16
2021-10-19,Tairawhiti,0,4,0,4
2021-10-19,Southern,0,215,2,217
2021-10-19,South Canterbury,0,17,0,17
2021-10-19,Northland,0,28,0,28
2021-10-19,Nelson Marlborough,0,49,0,49
2021-10-19,Mid Central,0,33,0,33
2021-10-19,Lakes,0,16,0,16
2021-10-19,Hutt Valley,0,24,0,24
2021-10-19,Hawke's Bay,0,44,0,44
2021-10-19,Counties Manukau,269,1081,2,1352
2021-10-19,Capital and Coast,0,111,2,113
2021-10-19,Canterbury,0,156,12,168
2021-10-19,Bay of Plenty,0,48,0,48
2021-10-19,Managed Isolation & Quarantine,23,1294,1,1318
2021-10-19,Total,736,4389,28,5153
2021-10-20,Auckland,126,483,1,610
2021-10-20,Whanganui,0,9,0,9
2021-10-20,West Coast,0,4,1,5
2021-10-20,Waitemata,315,549,5,869
2021-10-20,Wairarapa,0,8,0,8
2021-10-20,Waikato,46,203,2,251
2021-10-20,Taranaki,0,16,0,16
2021-10-20,Tairawhiti,0,4,0,4
2021-10-20,Southern,0,215,2,217
2021-10-20,South Canterbury,0,17,0,17
2021-10-20,Northland,0,28,0,28
2021-10-20,Nelson Marlborough,0,49,0,49
2021-10-20,Mid Central,0,33,0,33
2021-10-20,Lakes,0,16,0,16
2021-10-20,Hutt Valley,0,24,0,24
2021-10-20,Hawke's Bay,0,44,0,44
2021-10-20,Counties Manukau,280,1083,2,1365
2021-10-20,Capital and Coast,0,111,2,113
2021-10-20,Canterbury,0,156,12,168
2021-10-20,Bay of Plenty,0,48,0,48
2021-10-20,Managed Isolation & Quarantine,23,1295,1,1319
2021-10-20,Total,790,4395,28,5213
2021-10-21,Auckland,147,483,1,631
2021-10-21,Whanganui,0,9,0,9
2021-10-21,West Coast,0,4,1,5
2021-10-21,Waitemata,346,549,5,900
2021-10-21,Wairarapa,0,8,0,8
2021-10-21,Waikato,54,203,2,259
2021-10-21,Taranaki,0,16,0,16
2021-10-21,Tairawhiti,0,4,0,4
2021-10-21,Southern,0,215,2,217
2021-10-21,South Canterbury,0,17,0,17
2021-10-21,Northland,0,28,0,28
2021-10-21,Nelson Marlborough,0,49,0,49
2021-10-21,Mid Central,0,33,0,33
2021-10-21,Lakes,0,16,0,16
2021-10-21,Hutt Valley,0,24,0,24
2021-10-21,Hawke's Bay,0,44,0,44
2021-10-21,Counties Manukau,321,1084,2,1407
2021-10-21,Capital and Coast,0,111,2,113
2021-10-21,Canterbury,0,156,12,168
2021-10-21,Bay of Plenty,0,48,0,48
2021-10-21,Managed Isolation & Quarantine,23,1295,1,1319
2021-10-21,Total,891,4396,28,5315
2021-10-22,Auckland,174,485,1,660
2021-10-22,Whanganui,0,9,0,9
2021-10-22,West Coast,0,4,1,5
2021-10-22,Waitemata,395,550,5,950
2021-10-22,Wairarapa,0,8,0,8
2021-10-22,Waikato,61,205,2,268
2021-10-22,Taranaki,0,16,0,16
2021-10-22,Tairawhiti,0,4,0,4
2021-10-22,Southern,0,215,2,217
2021-10-22,South Canterbury,0,17,0,17
2021-10-22,Northland,0,28,0,28
2021-10-22,Nelson Marlborough,0,49,0,49
2021-10-22,Mid Central,0,33,0,33
2021-10-22,Lakes,0,16,0,16
2021-10-22,Hutt Valley,0,24,0,24
2021-10-22,Hawke's Bay,0,44,0,44
2021-10-22,Counties Manukau,362,1084,2,1448
2021-10-22,Capital and Coast,0,111,2,113
2021-10-22,Canterbury,0,156,12,168
2021-10-22,Bay of Plenty,0,48,0,48
2021-10-22,Managed Isolation & Quarantine,27,1296,1,1324
2021-10-22,Total,1019,4402,28,5449
2021-10-23,Auckland,190,487,1,678
2021-10-23,Whanganui,0,9,0,9
2021-10-23,West Coast,0,4,1,5
2021-10-23,Waitemata,434,551,5,990
2021-10-23,Wairarapa,0,8,0,8
2021-10-23,Waikato,67,207,2,276
2021-10-23,Taranaki,0,16,0,16
2021-10-23,Tairawhiti,0,4,0,4
2021-10-23,Southern,0,215,2,217
2021-10-23,South Canterbury,0,17,0,17
2021-10-23,Northland,4,28,0,32
2021-10-23,Nelson Marlborough,1,49,0,50
2021-10-23,Mid Central,0,33,0,33
2021-10-23,Lakes,0,16,0,16
2021-10-23,Hutt Valley,0,24,0,24
2021-10-23,Hawke's Bay,0,44,0,44
2021-10-23,Counties Manukau,394,1084,2,1480
2021-10-23,Capital and Coast,0,111,2,113
2021-10-23,Canterbury,0,156,12,168
2021-10-23,Bay of Plenty,0,48,0,48
2021-10-23,Managed Isolation & Quarantine,29,1296,1,1326
2021-10-23,Total,1119,4407,28,5554
2021-10-24,Auckland,205,495,1,701
2021-10-24,Whanganui,0,9,0,9
2021-10-24,West Coast,0,4,1,5
2021-10-24,Waitemata,435,572,5,1012
2021-10-24,Wairarapa,0,8,0,8
2021-10-24,Waikato,67,209,2,278
2021-10-24,Taranaki,0,16,0,16
2021-10-24,Tairawhiti,0,4,0,4
2021-10-24,Southern,0,215,2,217
2021-10-24,South Canterbury,0,17,0,17
2021-10-24,Northland,5,28,0,33
2021-10-24,Nelson Marlborough,1,49,0,50
2021-10-24,Mid Central,0,33,0,33
2021-10-24,Lakes,0,16,0,16
2021-10-24,Hutt Valley,0,24,0,24
2021-10-24,Hawke's Bay,0,44,0,44
2021-10-24,Counties Manukau,409,1101,2,1512
2021-10-24,Capital and Coast,0,111,2,113
2021-10-24,Canterbury,0,156,12,168
2021-10-24,Bay of Plenty,0,48,0,48
2021-10-24,Managed Isolation & Quarantine,31,1298,1,1330
2021-10-24,Total,1153,4457,28,5638
